faire une pioncette	dormir [v]: pioncer; en ecraser; roupiller																													
faire un tabac	avoir un grand succes [v]																													
faire valoir	exercer [v]: defendre	faire ressortir [v]: faire etalage de; mettre en vedette; faire mousser	exploiter [v]: mettre en valeur																											
faire vibrer	emouvoir vivement [v]: enflammer; ebranler; toucher																													
faire violence a	violer [v]: abuser																													
faire voir	montrer [v]: etaler; guider																													
fair-play	franc-jeu [a]: sport; correct; droit; loyal; honnete																													
faisable	realisable [a]: pratique; facile; possible; aise																													
faisande	pourri [a]: malsain; corrompu; douteux	avance [a]																												
faisanderie	elevage de faisans [n]																													
faisceau	fagot [n]: botte; gerbe; bouquet	accumulation [n]	faisceau lumineux [o]																											
faiseur	constructeur [n]: batisseur	fabricant [n]	tailleur [n]	amateur [n]	becheur [n]: hableur																									
fait	arrange [a]: constitue; dispose	accompli [a]: acheve; execute; termine; forme; bati	habitue [a]: accoutume	capable de [a]: bon pour; ne pour; propre a	mur [a]	acte [n]: action; exploit; chose faite	evenement [n]: cas; aventure; phenomene	de fait [o]: du fait de; en fait; fait pour; hauts faits; mal fait; mettre au fait de; se mettre au fait de																						
fait d armes	exploit [n]: prouesse; hauts faits																													
faite	comble [n]: apogee; pinacle; summum	sommet [n]: cime; point culminant																												
fait pour	propre a [o]																													
faix	tassement [n]	charge [n]: chargement; fardeau; poids; surcharge																												
fallacieux	insidieux [a]: hypocrite; fourbe; nuisible; mensonger; artificieux; trompeur; perfide; specieux; faux																													
falloir	devoir [v]: convenir; etre necessaire																													
falot	terne [a]: efface; pale; anodin; insignifiant; inconsistant; negligeable; mediocre	plaisant [a]: joyeux; gai; drole	lanterne [n]: flambeau; fanal																											
falsificateur	fabricateur [n]: fraudeur; contrefacteur																													
falsification	alteration [n]: contrefaçon																													
falsifie	factice [a]: faux																													
falsifier	contrefaire [v]: imiter; truquer	deformer [v]: alterer; denaturer; fausser; defigurer; adulterer; changer; frelater; tronquer; sophistiquer	travestir [v]: maquiller																											
falun	depot de coquilles [n]: lumachelle																													
fonds	capital [n]: bien; argent; pecule; finances	terrain [n]: sol; champ	commerce [n]: etablissement; boutique; magasin; maison																											
fondu	dissous [a]: liquefie; dilue; solubilise	flou [a]: vaporeux	degrade [a]																											
fongosite	excroissance [n]																													
fongus	champignon de mer [n]	tumeur [n]																												
fontaine	reservoir [n]: recipient; bassin; filtre; puits	source [n]: ruisseau; eau vive																												
fonte	fusion [n]: moulage	fourreau [n]																												
forain	etranger [n]: nomade; bateleur; batteur d estrade; marchand; banquiste; saltimbanque																													
forban	pirate [n]: corsaire	bandit [n]																												
forçat	galerien [n]: bagnard; prisonnier																													
force	etat physique [n]: robustesse; resistance; vigueur; virilite; verdeur; muscle; seve; solidite; tonicite; muscle; biceps; nerf; ressort	etat mental [n]: dynamisme; potentiel; pouvoir; puissance; intensite	trait de caractere [n]: courage; volonte; determination; fermete; energie; constance; cran	effet [n]: efficacite; intensite; activite; action; influence	langue [n]: eloquence; vehemence; virulence	fait [n]: obligation; necessite	opposition [n]: contrainte; oppression; violence																							
force	factice [a]: affecte; artificiel; contraint	necessaire [a]: obligatoire; ineluctable; inevitable; involontaire; ecrit																												
force d ame	ardeur [n]: courage; caractere; constance; valeur; volonte; heroisme; noblesse; generosite; magnanimite																													
forcement	forçage [n]: effraction																													
forcement	fatalement [o]: absolument; evidemment; inevitablement; necessairement; obligatoirement																													
forcene	furibond [a]: furieux; emporte	fou [a]	enrage [a]: acharne; passionne	energumene [n]																										
forcer	astreindre [v]: contraindre; obliger; entrainer; reduire; condamner	briser [v]: enfoncer; rompre; crocheter; fracturer; emporter; prendre	tyranniser [v]: violenter; faire violence; violer; faire subir	traquer [v]	hater [v]: precipiter; accentuer; accelerer	augmenter [v]: exagerer; outrer	fatiguer [v]: claquer; crever	denaturer [v]: solliciter																						
forcir	grossir [v]: se fortifier																													
foret	multitude [n]: grande quantite; amas	bois [n]: lieu sauvage; solitude																												
forfait	crime [n]: faute; delit; mefait; attentat	declarer forfait [o]																												
forfaiture	trahison [n]: felonie; concussion; prevarication																													
forfanterie	orgueil [n]: vantardise; charlatanisme; hablerie; rodomontade; fanfaronnade																													
forger	fabriquer [v]: inventer	battre [v]: corroyer; marteler																												
forgeur	fabricateur [n]: fabricant; inventeur	forgeron [n]																												
forlancer	forcer hors du gite [v]																													
formaliser	se formaliser [o]	vexer [v]: blesser; offenser; offusquer																												
formaliste	pointilleux [a]: vetilleux; minutieux; etroit	façonnier [a]: ceremonieux; protocolaire	rigoriste [a]: ritualiste																											
formalite	ceremonial [n]: ceremonie; etiquette	procedure [n]: loi; forme; maniere; regle; procede; mode																												
format	dimension [n]: grandeur; calibre; mesure; taille																													
formateur	formant [a]																													
formation	groupe [n]: groupement; parti; groupuscule; orchestre	creation [n]: elaboration; fondation; constitution; composition; institution; organisation; production; developpement; generation	puberte [n]	education [n]: instruction; noviciat; apprentissage	apparition [n]: origine																									
forme	etat [n]: apparence; aspect; configuration; conformation; dehors; disposition; figure; corps; façon	art [n]: silhouette; trace; modele; galbe; ligne; relief	droit [n]: formalite; formule	societe [n]: organisation; regime; statut	technique [n]: moule; gabarit; modele; carcasse; chassis; garniture	maniere [n]: etiquette; usages; formalite; bonnes manieres	langue [n]: expression; style																							
forme	nubile [a]: pubere; mur	developpe [a]: fait	instruit [a]																											
formel	precise [a]: explicite; expres; clair; determine; direct; net; precis	indubitable [a]: incontestable; rigoureux; indeniable; indiscutable; irrefutable; absolu; assure; authentique; categorique; certain; constant; evident; imperieux; positif																												
formellement	explicitement [o]: rigoureusement; certainement; nettement																													
former	societe [v]: fonder; instituer; organiser; etablir; creer	forme [v]: fabriquer; façonner; faire; composer; constituer; presenter; dessiner	etat mental [v]: concevoir; imaginer; mediter; projeter; dessiner; enoncer; formuler; preparer	savoir [v]: instruire; eduquer; elever; discipliner; entrainer; enseigner; initier; styler; dresser; cultiver; exercer																										
formes	contours [n]: lignes																													
formidable	imposant [a]: stupefiant; colossal; considerable; enorme; extraordinaire; gigantesque; monstrueux; etonnant	redoutable [a]: epouvantable; effrayant; effroyable; terrible; terrifiant; redoute	sensationnel [a]: epatant																											
formidablement	enormement [o]: considerablement	terriblement [o]: tres																												
formulaire	questionnaire [n]: formule	recueil [n]: codex; etiquette; modele; traite																												
formule	maniere [n]: methode; procede; recette; mode; solution; [informal] truc	langue [n]: expression; slogan; terme; aphorisme; dicton	droit [n]: enonce; libelle; intitule																											
formuler	emettre [v]: expliciter; exprimer; enoncer; deposer	etablir [v]	former [v]																											
fort	puissant [a]: robuste; solide; vigoureux; viril; athletique; herculeen; costaud; baleze; baraque	courageux [a]: ferme; energique	savant [a]: doue; habile; capable; experimente; cale	puissant [a]: influent	dur [a]: inusable	dru [a]: epais; touffu; serre; abondant	intense [a]: lourd	eleve [a]: grand; important	epice [a]: piquant; releve; acre; rude; vert; piquant; penetrant; desagreable	efficace [a]: irresistible; invincible	vehement [a]: vif; violent	incroyable [a]: extraordinaire; inoui; invraisemblable; outre; pousse; du tonnerre; de cheval; carabine; raide; fort de cafe	hercule [n]: malabar; costaud; baleze	defense [n]: citadelle; forteresse; fortin; bastion; blockhaus; ouvrage; redoute; retraite; retranchement; redan	beaucoup [o]: abondamment; amplement; considerablement; copieusement; en abondance; largement; a foison; a profusion	fortement [o]: ardemment; bien; dur; extremement; tout a fait; tres; violemment	etre fort [o]: se faire fort de													
fort de cafe	fort [o]: exagere																													
fortement	vigoureusement [o]: violemment; vivement; profondement; puissamment; solidement; avec force; energiquement; lourdement; nettement; fermement; intensement																													
forteresse	mur [n]: rempart; citadelle	fort [n]: citadelle; chateau; blockhaus; fortin; place forte																												
fortifiant	remontant [n]: reconstituant; tonique	vivifiant [a]: nourrissant; nutritif; reconstituant; remontant; restaurant; tonique																												
fortification	rempart [n]: defense																													
fortifier	armer [v]: proteger; defendre; retrancher; entourer	consolider [v]: renforcer; etayer	tremper [v]: durcir; endurcir; affermir	confirmer [v]: corroborer; raffermir; etayer	se fortifier [o]																									
fable	mensonge [n]: tromperie; imagination; fantaisie; elucubration; invention	conte [n]: anecdote; mythe; fiction; legende; recit; moralite; apologue; parabole; allegorie; fabliau																												
fabricant	fonction [n]: industriel; manufacturier; chef d etablissement																													
fabricateur	createur [n]: inventeur; producteur; artisan	falsificateur [n]: fraudeur; contrefacteur; faussaire																												
fabrication	creation [n]: invention; production; composition; confection																													
fabrique	fabrication [n]: façon	usine [n]: manufacture; etablissement industriel																												
fabrique	forge [a]: falsifie; invente; imagine; artificiel	cree [a]: manufacture; confectionne; façonne; bati; construit; usine; realise																												
fabriquer	fait [v]: faire; façonner; creer; realiser; former; confectionner; usiner; mettre en œuvre; manufacturer; produire; executer; elaborer; œuvrer; composer	etat mental [v]: inventer; imaginer; calomnier; medire; fausser; forger																												
fabulation	mythomanie [n]	affabulation [n]																												
fabuleusement	prodigieusement [o]: extremement																													
fabuleux	fantastique [a]: incroyable; miraculeux; prodigieux; etonnant; extraordinaire; inoui; romanesque	mythologique [a]: mythique; legendaire; chimerique; imaginaire; irreel; allegorique; faux; errone; fictif; illusoire																												
façade	devant [n]: front; face; devanture	exterieur [n]: aspect; dehors	de façade [o]																											
face	aspect [n]: apparence; point de vue; tournure	visage [n]: physionomie; figure; tete; mine	avers [n]	angle [n]: coin; cote; couture	façade [n]: front	en face [o]: en face de; face a face																								
facetie	bouffonnerie [n]: farce; mystification; plaisanterie; baliverne; tour; niche; pitrerie																													
facetieux	farceur [n]: plaisantin; blagueur; loustic; chahuteur	drole [a]: comique; plaisant; rejouissant; spirituel; moqueur; gouailleur; jovial																												
fache	navre [a]: desole; attriste	irrite [a]: froisse; contrarie; courrouce; ulcere; offusque; mecontent	etre fache [o]																											
facher	attrister [v]: chagriner; peiner; contrister; affliger; navrer	mecontenter [v]: contrarier; indisposer; vexer; agacer; irriter; exasperer; piquer	se facher [o]																											
facherie	contrariete [n]: depit; irritation	brouille [n]: desaccord; bouderie																												
facheux	genant [a]: ennuyeux; desagreable; embarrassant; deplaisant; embetant	regrettable [a]: contrariant; deplorable; malencontreux; malheureux; intempestif; inopportun	difficile [a]: penible	geneur [n]: importun; indiscret; raseur																										
facies	facies [o]																													
facies	visage [n]: figure; face	apparence [n]: aspect; configuration; structure; morphologie; facies																												
facile	trait de caractere [a]: docile; indulgent; conciliant; malleable; tolerant; accommodant; arrangeant; complaisant; doux; faible; traitable; libre; relache; bonhomme; leger	maniere [a]: commode; faisable; abordable; accessible; possible; praticable; realisable; simple; usuel; aise; executable; penetrable; naturel; ordinaire; elementaire																												
facilement	aisement [o]: commodement; naturellement; sans difficulte; comme une fleur																													
facilite	simplicite [n]: accessibilite; commodite	mobilite [n]: aise	chance [n]: latitude; liberte; avantage; moyen; jeu; marge; possibilite; occasion	aide [n]: appui; secours	aptitude [n]: aisance; don; adresse; brio; habilete; faculte; naturel; vocation; disposition	douceur [n]: indulgence	condescendance [n]: complaisance; faiblesse; laisser-aller; paresse; relachement; mollesse	verve [n]: faconde																						
faciliter	simplifier [v]: menager; arranger; aplanir; preparer; aider; macher la besogne																													
façon	forme [n]: configuration; conformation	moyen [n]: methode; mode; procede	technique [n]: creation; fabrication; travail; execution; confection; coupe	maniere [n]: conduite; comportement; air; allure; attitude; degaine; ton																										
faconde	volubilite [n]: facilite; exuberance; bagou; verve; abondance; loquacite; prolixite																													
façonner	confectionner [v]: modeler; sculpter	travailler [v]: usiner; fabriquer; elaborer; faire; ouvrer	preparer [v]: appreter; petrir	tourner [v]	labourer [v]	former [v]: dresser; modifier; eduquer; transformer	habituer [v]: accoutumer; plier																							
façonnier	affecte [a]: ceremonieux; maniere; precieux; poseur; minaudier; apprete; artificiel; pretentieux	artisan [n]: ouvrier																												
façons	chichis [n]: simagrees; minauderies; ceremonies; airs; embarras; histoires																													
fac-simile	copie [n]: reproduction; imitation; double; figuration																													
facteur	messager [n]: commissionnaire; mandataire; agent; commis; intermediaire; envoye; estafette; expres	fabricant d orgues [n]: accordeur; luthier	element [n]: agent; cause	coefficient [n]: puissance; rapport; quotient; multiplicande; multiplicateur; diviseur																										
factice	faux [a]: falsifie; copie; artificiel; imite; affecte; feint; fictif; force; postiche; compose; emprunte																													
factieux	agitateur [n]: insurge; agent provocateur; mutin; revolutionnaire; rebelle; revolte; semeur de troubles	revolutionnaire [a]: rebelle; seditieux; sectaire; reactionnaire; subversif; revolte; insurge; insurrectionnel																												
faction	garde [n]: guet	complot [n]: cabale; conjuration; conspiration; rebellion; sedition; agitation; brigue; intrigue; mutinerie; ligue; revolution	etre en faction [o]																											
factionnaire	sentinelle [n]																													
factum	pamphlet [n]: libelle; diatribe	memoire [n]: expose																												
facture	compte [n]: etat; addition; note; releve; bordereau; memoire	maniere [n]: style; technique; execution; travail																												
faculte	talent [n]: aptitude; facilite; capacite; don; ressource	moyen [n]: possibilite; pouvoir; puissance; capacite; droit; liberte; latitude; privilege; autorisation	enseignement superieur [n]: universite																											
fada	fou [n]: cingle	un peu fou [a]: cingle																												
fadaise	bagatelle [n]: vetille; betise	platitude [n]: niaiserie; baliverne; calembredaine; sornette; billevesee																												
fade	pale [a]: terne; delave	insipide [a]: ecœurant; douceatre; doucereux; fadasse	ennuyeux [a]: insipide; plat; insignifiant; inexpressif; sans caractere	rendre fade [o]																										
fadeur	insipidite [n]	platitude [n]: manque de caractere; manque d interet; manque de vivacite; convention; affectation	fadaise [n]																											
fagot	bourree [n]: fascine; javelle; cotret; margotin																													
fagote	affuble [a]: accoutre; mal vetu; ficele																													
fagoter	vetir [v]: habiller																													
faible	etat physique [a]: affaibli; chetif; debile; fragile; malingre; deficient; delicat; fluet; asthenique; infirme; rachitique; anemie; anemique; frele; grele	trait de caractere [a]: desarme; impuissant; vulnerable; vacillant; instable; inconstant; veule; lache; mou; pliant; flasque; sans fermete	qualite [a]: insuffisant; mediocre; mauvais	personne [n]: avorton; gringalet	gout [n]: penchant																									
faiblement	peu [o]: insuffisamment	doucement [o]: vaguement; mollement																												
faiblesse	syncope [n]: evanouissement; defaillance; pamoison	fragilite [n]: debilite; anemie; deficience; delicatesse; abattement; affaiblissement; impuissance; manque de puissance; infirmite; asthenie	insuffisance [n]: inferiorite; insignifiance; mediocrite; pauvrete; point faible; trou; lacune	entrainement [n]: erreur; faute; glissade	complaisance [n]: apathie; aveulissement; irresolution; indecision; laisser-aller; langueur; mollesse; lachete; facilite	preference [n]: penchant	faiblesse d esprit [o]																							
faiblir	s affaiblir [v]: s epuiser; decliner; defaillir	plier [v]: ployer; vaciller; baisser; ceder; chanceler; flechir; mollir																												
faience	ceramique [n]: cailloutage																													
faillir	etre sur le point de [v]	manquer a [v]: negliger; se derober; s esquiver	commettre une faute [v]: succomber; choir; tomber; fauter; pecher																											
faillite	debacle [n]: banqueroute; krach; ruine; depot de bilan; liquidation judiciaire; deconfiture																													
faim	etat mental [n]: besoin; desir; envie; soif; ambition; appetence	etat physique [n]: appetit; boulimie; fringale																												
faineant	paresseux [n]: bon a rien; desœuvre; oisif; flemard; flemmard; feignant; faignant	paresseux [a]: apathique; desœuvre; inactif; indolent; inutile; musard; nonchalant; oisif; propice a rien; flemard; flemmard; feignant; faignant																												
faineanter	paresser [v]: lezarder; flemmarder; coincer la bulle; glander; glandouiller																													
faineantise	paresse [n]: oisivete; inaction; inertie; apathie																													
faire	travailler [v]: etudier; s occuper; se taper	entreprendre [v]: accomplir; effectuer; agir; executer; realiser; pratiquer; remplir une tache; ficher; foutre	preparer [v]: creer; composer; produire; engendrer; fabriquer; façonner; confectionner; construire; batir; eriger	conditionner [v]: former	instaurer [v]: instituer; etablir; constituer	arranger [v]: combiner; disposer; nettoyer; ranger	causer [v]: occasionner; determiner	contrefaire [v]: feindre d etre; jouer le role de; affecter de	commettre [v]: perpetrer; provoquer	gagner [v]: obtenir; amasser; procurer; se procurer	representer [v]: etre; valoir	se comporter [v]	s attirer [v]	rendre [v]	observer [v]: operer; mettre en pratique	cultiver [v]: recolter; semer	faire cas [o]: faire cas de; faire etat de; faire en sorte que; faire face; faire face a; faire-part; s en faire; se faire													
faire abstraction	abstraire [v]: ecarter; exclure; retirer; ne pas tenir compte																													
faire abstraction de	ecarter [v]																													
faire admettre	introduire [v]																													
faire apparaitre	evoquer [v]																													
faire attention	etat [v]: etre prudent																													
faire attention a	veiller a [v]																													
faire bonne mine	faire bon accueil [v]																													
faire cas de	compter [v]: considerer																													
faire chanceler	ebranler [v]: rendre incertain; affaiblir																													
faire chorus	etre du meme avis [v]																													
faire confiance a	avoir confiance dans [v]: compter sur																													
faire connaitre	exprimer [v]: designer; donner; denoncer; indiquer																													
faire courir	colporter [v]: repandre; divulguer; propager																													
faire dechoir	abaisser [v]: degrader																													
faire defaut	defaillir [v]: manquer																													
faire de l effet	faire sensation [v]	operer [v]: agir																												
faire des gorges chaudes	se moquer de [v]: railler																													
faire des libations	boire abondamment [v]																													
faire des siennes	faire des sottises [v]																													
faire disparaitre	vaincre [v]: lever; dissiper	enlever [v]: cacher; effacer; escamoter	chasser [v]: detruire; aneantir; supprimer	exterminer [v]: tuer																										
faire durer	eterniser [v]: prolonger; proroger; trainer	economiser [v]: epargner; conserver																												
faire echouer	dejouer [v]: confondre																													
faire effort	s efforcer [v]: s escrimer																													
faire entendre	enoncer [v]: dire; exprimer; emettre																													
faire etat de	arguer [v]: citer																													
faire explosion	fulminer [v]	eclater [v]																												
faire fausse route	se tromper [v]: s egarer																													
faire fi de	mepriser [v]																													
faire flores	fleurir [v]: briller; reussir; avoir du succes																													
faire fondre	dissoudre [v]: delayer																													
faire fureur	susciter le plus grand engouement [v]: connaitre un immense succes																													
faire grace	pardonner [v]: epargner																													
faire grise mine	accueillir avec froideur [v]																													
faire halte	s arreter [v]: arreter																													
faire hommage	dedier [v]: offrir																													
faire joujou	jouer [v]: s amuser; s ebattre; s ebrouer																													
faire justice	punir [v]																													
faire la fete	faire la noce [v]: faire la bombe; faire bombance; faire la vie; faire la foire																													
faire l affaire	convenir [v]																													
faire la guerre a	combattre [v]	reprimander [v]																												
faire la lippe	bouder [v]: faire la moue																													
faire la roue	se pavaner [v]: se rengorger																													
faire la soudure	repondre aux besoins [v]: repondre a la demande																													
faire le flambard	faire le fanfaron [v]: faire le malin; craner																													
faire le grand seigneur	depenser sans compter [v]: etre genereux avec ostentation																													
faire le saut	se resoudre a [v]: se decider a; franchir le Rubicon																													
faire le trottoir	se livrer a la prostitution [v]: faire du racolage; faire le tapin																													
faire le zigoto	faire le malin [v]: faire l interessant																													
faire le zouave	faire le malin [v]: faire le pitre; faire le guignol																													
faire marrer	faire rire [v]: faire rigoler; amuser																													
faire mine de	donner l apparence de [v]: donner l impression que	faire semblant de [v]																												
faire miroiter	promettre [v]																													
faire monter	elever [v]: exhausser																													
faire mourir	frapper a mort [v]: expedier																													
faire naitre	engendrer [v]: exciter; susciter; eveiller																													
faire paraitre	sortir [v]: deployer																													
faire participer	associer [v]: admettre																													
faire partie de	appartenir a [v]: etre membre de	contenir [v]: entrer																												
faire partir	expedier [v]: emballer																													
faire parvenir	communiquer [v]: acheminer; adresser; transmettre																													
faire penetrer	enfoncer [v]																													
faire penser a	rappeler [v]																													
faire perdre la raison	derouter [v]: abuser; egarer																													
faire perir	exterminer [v]: annihiler																													
faire plaisir	plaire [v]: rejouir																													
faire ressortir	accentuer [v]: detacher																													
faire revenir	faire rissoler [v]	rappeler [v]																												
faire saillie	saillir [v]: sortir																													
faire sauter	dynamiter [v]: miner	cuire a feu vif [v]	eliminer [v]																											
faire savoir	apprendre [v]: informer; instruire; enseigner; signaler; signifier; mander																													
faire semblant	feindre [v]: dissimuler; simuler																													
faire sortir	mouvement [v]: expulser																													
faire sortir de	tirer [v]																													
faire souffrir	battre [v]: faire mal; tourmenter; torturer																													
faire supposer	impliquer [v]: inclure																													
faire tache d huile	se repandre [v]: faire boule de neige																													
faire taire	reduire au silence [v]: imposer silence; clouer le bec	calmer [v]: empecher de parler; empecher de crier; empecher de pleurer																												
faire tomber	induire [v]	abattre [v]																												
faire tort	leser [v]: deshonorer; porter atteinte a																													
faire trainer	temporiser [v]: atermoyer; faire languir; tarder; retarder; repousser; reculer; remettre; proroger; surseoir a																													
fame	mal fame [o]																													
famelique	affame [a]: misereux; meurt-de-faim; creve-la-faim																													
fameux	qualite [a]: celebre; connu; glorieux; repute; renomme; memorable; superieur; brillant; illustre; grand; inoubliable; insigne	gout [a]: excellent; tres bon																												
familial	domestique [a]: parental																													
familiariser	apprivoiser [v]: dresser; entrainer	habituer [v]: accoutumer; acclimater	se familiariser [o]																											
familiarite	maniere [n]: bonhomie; abandon; liberte; grossierete; desinvolture; effronterie; sans-gene; privaute; liberte	relation [n]: intimite; habitude; frequentation																												
familier	libre [a]: grossier; cavalier	connu [a]: ordinaire; habituel; coutumier; simple; usite	liant [a]: accessible; simple	habitue [n]																										
familierement	librement [o]: simplement; a batons rompus																													
famille	relation [n]: menage; foyer; maison; maisonnee; toit; logis; tribu; progeniture; [informal] smala; marmaille	societe [n]: descendance; generation; lignee; dynastie; race; posterite; sang; maison; extraction; origine; parente; nom; naissance; souche	forme [n]: groupe; genre																											
famine	faim [n]: absence d aliments; manque de vivres; misere; disette																													
fanal	lanterne [n]: feu; falot; phare; flambeau																													
fanatique	sectaire [a]: intolerant	passionne [a]: fervent; exalte; ardent; chaleureux; enthousiaste; fougueux; fou; zele; transporte; enrage; amoureux	passionne [n]: fervent; fan; exalte; enthousiaste; zelateur; fana																											
fanatisme	passion [n]: zele	sectarisme [n]: intolerance; etroitesse de vue																												
fane	defraichi [a]: bleme; terne; use; vieilli; fatigue																													
faner	fletrir [v]: defraichir; decolorer; ternir; secher	se faner [o]																												
fanfare	fracas [n]: eclat	musique [n]																												
fanfaron	menteur [n]: hableur; craneur; fendant; gascon; matamore; rodomont; fier-a-bras	vantard [a]: hableur; suffisant; pretentieux; vaniteux																												
fanfaronnade	vantardise [n]: forfanterie; hablerie; bravade; gasconnade; rodomontade																													
fanfaronner	se vanter [v]: craner; poser																													
fanfreluche	frivolite [n]: ornement																													
fange	ignominie [n]: abjection; bassesse	boue [n]: bourbe; immondice; ordure; vase; crotte; limon																												
fangeux	vaseux [a]: boueux; trouble; abject																													
fanion	drapeau [n]: etendard																													
fantaisie	esprit [n]: boutade; humour	imagination [n]: illusion; idee; pensee; reverie; utopie; chimere	fable [n]	caprice [n]: extravagance; envie; desir; folie; lubie; volonte passagere	gre [n]: gout; guise; predilection																									
fantaisiste	fumiste [n]: original; amateur; humoriste; dilettante	capricieux [a]: changeant; inconstant; dilettante; versatile																												
fantasque	capricieux [a]: changeant; bizarre; etrange; versatile; fantaisiste; lunatique; original; saugrenu																													
fantastique	etonnant [a]: extravagant; extraordinaire; bizarre; enorme; invraisemblable; merveilleux; sensationnel; admirable; chimerique; colossal; fabuleux; gigantesque; incoherent; abracadabrant	surnaturel [a]: irreel; imaginaire; feerique; fantasmagorique; miraculeux																												
fantoche	pantin [n]	marionnette [n]: guignol; pantin; polichinelle																												
fantome	ombre [n]: apparence; chimere; simulacre	apparition [n]: spectre; revenant; vision; epouvantail; esprit																												
faquin	coquin [n]: garnement; maraud; sacripant; vaurien; chenapan; canaille																													
faramineux	etonnant [a]: extraordinaire; prodigieux																													
faraud	fanfaron [n]: vantard; pretentieux																													
farce	comedie [n]: piece comique	hachis [n]	facetie [n]: plaisanterie; tromperie; malice; mystification; attrape; blague; canular; malice; tour; niche																											
farceur	mauvais plaisant [n]	blagueur [n]: mystificateur; plaisantin																												
farci	plein [a]: bourre	rempli de farce [a]																												
farcir	bourrer [v]: truffer	remplir [v]: garnir de farce	se farcir quelque chose [o]: se farcir quelqu un																											
fard	deguisement [n]: dissimulation; artifice; trompe l œil	maquillage [n]: fond de teint; rouge; mascara; rimmel; poudre; cosmetique																												
farde	artificiel [a]	maquille [a]	tres farde [o]: trop farde																											
fardeau	charge [n]: poids; faix; joug																													
farder	forme [v]: maquiller; grimer; mettre du fard a	maniere [v]: masquer; deguiser; dissimuler; envelopper; embellir; voiler	navigation[v]: gonfler																											
fardier	chariot a deux roues [n]: binard																													
farfadet	esprit follet [n]: lutin																													
farfouiller	chercher [v]: fouiller; bouleverser; fureter; fourrager; fourgonner; mettre en desordre; retourner sans dessus dessous; trifouiller																													
faribole	baliverne [n]: sornette; betise																													
farine	de la meme farine [o]: se faire rouler dans la farine	fecule [n]: maizena; mouture; gruau																												
farouche	trait de caractere [a]: cruel; dur; barbare; rude; violent; feroce; acharne; tenace	animal [a]: sauvage; indompte																												
farouchement	durement [o]: violemment																													
fascinant	extraordinaire [a]: envoutant; merveilleux; troublant; attachant; charmant; seduisant																													
fascination	attrait [n]: charme; seduction; appel; eblouissement; envoutement; trouble	ensorcellement [n]: hypnotisme; magie																												
fascine	fagot [n]: faix																													
fasciner	attirer [v]: captiver; charmer; emerveiller; envouter; seduire; troubler; conquerir; eblouir; egarer; plaire	hypnotiser [v]: magnetiser																												
faste	luxe [n]: grandeur; appareil; apparat; magnificence; ostentation; pompe; somptuosite; splendeur; eclat; brillant; etalage; opulence	favorable [a]: heureux; propice																												
fastes	calendrier [n]: annales; archives; histoire; memoires; chroniques																													
fastidieux	agaçant [a]: importun; lassant; deplaisant; enervant; ennuyeux; fatigant; insipide; insupportable; long; assommant; endormant; barbant																													
fastueux	somptueux [a]: magnifique; opulent; luxueux; riche; imposant; beau; eclatant																													
fat	poseur [n]: pretentieux; vaniteux	arrogant [a]: avantageux; impertinent; orgueilleux; pretentieux; poseur; sot; vain; vaniteux; infatue; suffisant																												
fatal	inevitable [a]: irrevocable; immanquable; ineluctable; certain; marque par le destin; obligatoire; ecrit	mortel [a]: funeste; nefaste; nuisible; deplorable; malheureux																												
fatalement	inevitablement [o]: forcement; necessairement; obligatoirement																													
fataliste	resigne [a]: philosophe																													
fatalite	catastrophe [n]: adversite; calamite; desastre; malediction; circonstance malheureuse; eventualite facheuse	destin [n]: destinee; fatum; etoile; hasard; sort																												
fatigant	abrutissant [a]	epuisant [a]: extenuant; ereintant; penible; accablant; tuant; crevant	fastidieux [a]: assommant; lassant; ennuyeux; barbant; rasant																											
fatigue	ennui [n]: tracas	epuisement [n]: ereintement; extenuation; abattement; accablement; lassitude; surmenage; harassement; coup de pompe	deformation [n]: changement d etat	brise de fatigue [o]																										
fatigue	etat physique [a]: las; rompu; recru; rendu; brise; harasse; ereinte; extenue; epuise; moulu; courbatu; courbature; vanne; vide	etat mental [a]: excede; lasse; sature; degoute	etat [a]: usage; defraichi; use; abime; deforme	corps [a]: faible; souffrant; derange																										
fatiguer	etat physique [v]: epuiser; extenuer; harasser; accabler; briser; echiner; ecraser; ereinter; lasser; surmener; [informal] esquinter; [informal] claquer; [informal] crever	etat mental [v]: ennuyer; etourdir; degouter; exceder; importuner; rebuter; harceler; tracasser; assommer; [informal] raser																												
fatiguer extremement	esquinter [v]: ereinter																													
fatras	galimatias [n]	desordre [n]: amas; entassement; monceau; confusion																												
fatuite	orgueil [n]: infatuation; outrecuidance; pretention; vanite; suffisance; importance																													
fatum	destin [n]: fatalite																													
fauber	faubert [n]: balai; vadrouille																													
faubert	fauber [o]																													
faubourg	banlieue [n]: peripherie																													
faubourien	populacier [a]: vulgaire; commun	resident de banlieue [n]																												
fauche	sans argent [a]: desargente																													
faucher	abattre [v]: renverser; detruire; aneantir; coucher	moissonner [v]: couper	voler [v]: derober; chiper; piquer; barboter																											
faucon	epervier [n]	crecerelle [n]: emerillon; emouchet; epervier; gerfaut; hobereau; laneret; lanier; pelerin; sacre; tiercelet	petit canon [n]: fauconneau																											
fauconnerie	volerie [n]	affaitage [n]																												
faufiler	se faufiler [o]	batir [v]																												
faune	satyre [n]: chevre-pied; sylvain	avifaune [n]																												
faussaire	contrefacteur [n]: faux-monnayeur; escroc; fripon																													
fausser	abimer [v]	falsifier [v]: denaturer; contrefaire; deformer; adulterer; alterer; farder; frelater; maquiller; pervertir; travestir; vicier	courber [v]: bossuer; bosseler; plier; tordre; forcer	fausser compagnie [o]																										
fausser compagnie	abandonner [v]: quitter																													
faussete	hypocrisie [n]: duplicite; fourberie; deloyaute; pharisaisme; tartufferie; affectation; contrefaçon; dissimulation	mensonge [n]: erreur; imposture; inexactitude; tromperie																												
faute	societe [n]: delit; forfait; peche; inconduite; infraction; crime; mefait; offense; chute; mauvaise action; negligence; peccadille	etat [n]: absence; manque; privation; defaut	langue [n]: erreur; inattention; inexactitude; irregularite; omission; abus; anachronisme; lapsus; sottise; tort																											
fauteuil	siege [n]: place																													
fauteur	excitateur [n]: instigateur; fomentateur; provocateur																													
fautif	defectueux [a]: vicieux	coupable [a]																												
fauve	bete feroce [n]: bete sauvage; carnassier; carnivore; felin; lion; panthere; tigre; leopard	roux [a]: roussatre; jaune; mordore																												
faux	qualite [a]: inexact; infidele; incorrect; imaginaire; errone; controuve; injuste; insoutenable; invente; mal fonde; irrationnel; mensonger; vain; suppose; pretendu	etat [a]: falsifie; contrefait; copie; factice; altere; artificiel; feint; frelate; pastiche; plagie; postiche; simule; sophistique; trompeur; truque	musique [a]: discordant	trait de caractere [a]: fourbe; hypocrite; sournois; tortueux; traitre; machiavelique; perfide	objet [n]: copie; pastiche; contrefaçon	fait [n]: mensonge; illusion	technique [n]: faucille; fauchon; faucard; fauchard																							
faux bruit	canular [n]: fausse nouvelle; farce																													
faux col	mousse [n]																													
faux-fuyant	excuse [n]: pretexte; echappatoire; atermoiement; fuite																													
faux pas	faute [n]: faiblesse; ecart de conduite	chute [n]: glissade																												
faveur	estime [n]: popularite; vogue; consideration	privilege [n]: avantage; credit; honneur; pouvoir; service	complaisance [n]: grace; amour; bienfait; bon office; amitie; benediction; plaisir	bienveillance [n]: appui; bonnes graces	en faveur de [o]																									
favorable	commode [a]: propice; opportun; avantageux; convenable; bon; heureux	accommodant [a]: bienveillant; complaisant; clement; indulgent; obligeant; secourable; sympathique	se rendre favorable [o]																											
favorablement	bien [o]: heureusement; avantageusement																													
favori	prefere [n]: mignon; courtisan; chouchou	prefere [a]: elu; privilegie; protege	patte [n]: patte de lapin; rouflaquette																											
favorise	privilegie [a]: heureux; bien loti																													
favoriser	faciliter [v]: feconder	aider [v]: avantager; encourager; seconder; proteger; soutenir																												
favus	dermatose [n]: teigne; pelade																													
fayot	sous-officier rengage [n]	haricot sec [n]																												
feal	fidele [a]: devoue; loyal	partisan [n]: ami devoue; ami fidele																												
febrile	nerveux [a]: enerve; excite	fievreux [a]																												
febrilite	agitation [n]: excitation; nervosite																													
feces	excrements [n]: defecation																													
fecond	personne, animal [a]: prolifique	nature [a]: fertile; productif; genereux; riche	fait [a]: fructueux; abondant; inepuisable; riche																											
feconder	fertiliser [v]: impregner	engendrer [v]	enrichir [v]																											
fecondite	fertilite [n]: productivite	faculte de reproduction [n]	richesse [n]																											
fedai	fedayin [o]																													
fedayin	resistant palestinien [n]: fedai																													
federation	association [n]: groupement; societe; ligue; union; syndicat; amicale																													
feerique	magique [a]: merveilleux; fantastique																													
feindre	dissimuler [v]: mentir; deguiser	simuler [v]: affecter; faire semblant; imiter; contrefaire																												
feint	artificiel [a]: simule	faux [a]: fictif; factice; controuve; imaginaire; de commande																												
feinte	dissimulation [n]: hypocrisie; mensonge; comedie; ruse; simulation; tromperie; artifice; deguisement	piege [n]: attrape																												
feinter	tromper par une feinte [v]	faire une feinte [v]	tromper [v]: rouler; avoir; posseder																											
fele	un peu fou [a]	ebreche [a]: lezarde; craquele																												
feler	se feler [o]																													
felicitation	eloge [n]: glorification; louange; panegyrique; applaudissement	compliment [n]: congratulation																												
felicite	bonheur [n]: beatitude; bien-etre; contentement; joie; paradis; plaisir; prosperite; delices; enchantement; extase; fortune; aise; chance																													
feliciter	relation [v]: applaudir; approuver; complimenter; louer; vanter; saluer																													
feliciter de	louer de [v]																													
felin	fauve [n]																													
felon	deloyal [a]: hypocrite; infidele; traitre; rebelle																													
felonie	trahison [n]: forfaiture	deloyaute [n]: acte deloyal; infidelite																												
felure	fente [n]: cassure; fissure																													
feminin	trait de caractere [a]: effemine; feministe																													
femme	personne [n]: epouse; conjointe; compagne; [informal] bonne femme; [informal] nana; [informal] pepee; [informal] souris	femme grande et maigre [n]: [informal] cheval; echalas; grande perche; sauterelle; grande bringue	jolie femme [n]: beaute; pin-up	femme petite et grosse [n]: [informal] tonneau; boudin	femme autoritaire [n]: dragon; gendarme																									
femme de chambre	bonne [n]: servante; femme de menage; cameriste; soubrette																													
femme de menage	bonne [n]: servante; femme de chambre; cameriste; soubrette																													
femme entretenue	demi-mondaine [n]																													
fenaison	recolte [n]: foin; moisson																													
fendant	bravache [n]: fier-a-bras; matamore; rodomont																													
fendille	gerce [a]: lezarde																													
fendiller	se fendiller [o]																													
fendre	feler [v]: lezarder; creuser; crever; rainer; rayer; strier	diviser [v]: couper; ecarter; ouvrir; separer; sectionner; inciser; penetrer; traverser; briser; dechirer	se fendre [o]: se fendre de																											
fendu	ouvert [a]: gerce; fele																													
fenetre	construction [n]: ouverture; baie; bow-window; hublot; lucarne; chassis; croisee; œil-de-bœuf; tabatiere; vasistas; vitrail; vitrine																													
fente	felure [n]: fissure; brisure; cassure; crevasse; lezarde	creux [n]: cavite; excavation; intervalle; ouverture; trou; vide; jour; judas	scissure [n]: gerçure; commissure	rainure [n]: rayure; echancrure; ride; striure	meurtriere [n]: chantepleure																									
feodalite	moyen age [n]																													
fer	epee [n]: fleuret	metal [n]	ferrure [n]	alliages de fer [o]: battre le fer; chemin de fer; debris de fer; de fer; en fer a cheval; fer-blanc; fer de lance; en fer de lance; fer etame; fer lamine; garniture en fer; minerais de fer; les quatre fers en l air; tomber les quatre fers en l air																										
fer-blanc	fer etame [n]: tole																													
fer de lance	pointe [n]																													
fer etame	fer-blanc [n]																													
fer lamine	tole [n]																													
fermage	exploitation [n]	affermage [n]: metayage																												
fermail	agrafe [n]: fermoir de livre																													
ferme	consistant [a]: dur; resistant; fort; solide; rigide; ancre; vigoureux; homogene	inflexible [a]: resolu; imperturbable; impassible; inebranlable; intransigeant; persistant; rigoureux; resolu; tenace; constant; energique; decide; determine; assure	fixe [a]: stable	cession de jouissance [n]: convention de louage	domaine rural [n]: exploitation agricole; metairie	charpente [n]: comble																								
ferme	enclos [a]: enferme	clos [a]: barricade; verrouille; cadenasse; mure	bouche [a]: obstrue	condamne [a]: interdit	rebelle [a]: impenetrable; indocile; etranger; renferme; taciturne																									
fermement	maniere [o]: energiquement; constamment																													
ferment	agent [n]: germe; cause; levain; source	levure [n]: levain; moisissure; enzyme; bacterie																												
fermentation	agitation [n]: bouillonnement; effervescence; surexcitation; remous; fievre	ebullition [n]: travail																												
fermenter	s agiter [v]: s echauffer; bouillonner; mijoter	lever [v]: chauffer; travailler																												
fermer	entourer [v]: cerner; enclore; enfermer	clore [v]: barricader; verrouiller; cadenasser; murer; sceller	boucher [v]: obstruer	interdire [v]: condamner; empecher l acces; ecluser; barrer le passage; endiguer; aveugler	arreter [v]: eteindre; terminer; couper; disjoncter	fixer [v]: agrafer; boutonner; cacheter	faire relache [v]: faire la semaine anglaise; chomer	se fermer [o]																						
fermete	resolution [n]: assurance; audace; certitude; courage; decision; energie; hardiesse; sang-froid; endurance	solidite [n]: consistance; resistance; force; durete; stabilite; vigueur	constance [n]: tenacite; volonte; opiniatrete	fermete d ame [o]: sans fermete																										
fermeture	serrure [n]: verrou; clef; cadenas; loquet	barricade [n]: barrage; cloture; grille; porte; vantail; volet; tampon; occlusion; chassis	arret [n]: cessation; suspension; interdiction																											
fermier	droit [n]: metayer; tenancier; locataire	fonction [n]: agriculteur; cultivateur; paysan; exploitant agricole																												
feroce	animal [a]: sanguinaire; sauvage	personne [a]: barbare; cruel; brutal; violent; acharne; sadique; inhumain; impitoyable; implacable; insensible	maniere [a]: terrible																											
ferocite	barbarie [n]: atrocite; brutalite; cruaute; inhumanite; sauvagerie; furie; sevices; violence																													
ferraille	objet [n]: assemblage metallique; vehicule	limaille [n]: debris de metaux; bouts de fer; copeaux; dechets; rebuts	petite monnaie [n]: mitraille																											
ferrailler	se battre [v]: combattre; lutter; se disputer; en decoudre	croiser le fer [v]: se battre a l arme blanche; escrimer; se battre en duel																												
ferrailleur	querelleur [n]	bretteur [n]: duelliste	marchand de ferraille [n]	brocanteur [n]																										
ferratier	marteau de marechal-ferrant [n]																													
ferre	instruit [a]: erudit; savant; tres competent; fort; cale	barde [a]: garni de fer; pare; protege																												
ferretier	ferratier [o]																													
ferrure	charniere [n]: gond; ferronnerie; garniture de fer; instrument en fer; serrure; penture																													
fers	oppression [n]: esclavage	chaines [n]: liens																												
fertile	quantite [a]: fecond; fructueux; prolifique; riche; prodigue; abondant; genereux; producteur; productif																													
fertiliser	ameliorer [v]: amender; feconder; bonifier																													
fertilite	fecondite [n]: richesse																													
feru	passionne [a]: epris																													
ferule	autorite [n]: pouvoir; direction																													
fervent	fanatique [n]: admirateur	ardent [a]: brulant; chaud; enthousiaste; fanatique; zele; mystique; pieux																												
ferveur	devotion [n]: amour; recueillement; piete; onction; zele	ardeur [n]: chaleur; enthousiasme; exaltation; feu; flamme; force																												
fessee	defaite [n]: raclee; deculottee; torchee	correction [n]: coup; fustigation																												
fesser	battre [v]: corriger; frapper; taper; flageller																													
festin	repas [n]: banquet; agapes; bombe; bombance; ripaille; gueuleton; brifeton; lippee																													
festival	gala [n]: recital	festivite [n]: fete	celebration [n]: kermesse; foire; manifestation																											
festivite	rejouissance [n]: allegresse	festival [n]: celebration; manifestation; partie; kermesse; ceremonie																												
festonner	decorer [v]: broder																													
fetard	jouisseur [n]: viveur; noctambule; noceur																													
fete	amusement [n]: divertissement; plaisir; rejouissance	solennite [n]: commemoration; anniversaire; jubile; ceremonie	gala [n]: bal; soiree; reception	festin [n]	festival [n]	kermesse [n]	faire la fete [o]																							
feter	fait [v]: celebrer; commemorer; solenniser; [informal] arroser																													
fetiche	amulette [n]: idole; talisman; porte-bonheur; mascotte																													
fetichisme	idolatrie [n]: veneration; superstition																													
fetide	puant [a]: malodorant; nauseabond; repugnant; empeste; repoussant; degoutant; ecœurant; immonde; infect; pestilentiel; putride; mephitique																													
fetidite	puanteur [n]: infection																													
feu	defunt [a]	incendie [n]: embrasement; combustion; brasier; flambee; sinistre	famille [n]: foyer; menage	lumiere [n]: lueur; fanal; signal	ardeur [n]: chaleur; exaltation; entrainement; ferveur; fougue; vehemence; vivacite; conviction	trouble [n]: agitation; revolution	amour [n]: flamme; passion	faire long feu [o]: feu du ciel; feux; mettre le feu a; prendre feu																						
feuillage	charmille [n]: tonnelle; dais; berceau; ombrage	frondaison [n]: feuillee; ramee; ramure; verdure; feuilles	chevelure [n]																											
feuille	page [n]: petit ecrit; imprime; carton; document; papier; formulaire; feuillet; journal; gazette	fibre [n]: lame; lamelle; plaque	oreille [n]	feuilles [o]: feuille de chou																										
feuille	feuillu [a]: touffu																													
feuille de chou	mauvais journal [n]																													
feuillee	feuillees [o]	ombrage [n]: abri; ramee; tonnelle; treille; feuillage; ramee																												
feuilles	verdure [n]: feuillage; vegetation; petales; folioles; frondaison																													
feuilleter	consulter [v]: parcourir; lire																													
feuillu	touffu [a]: fourni; garni; feuille																													
feutre	silencieux [a]: discret; etouffe; ouate	garni de feutre [a]																												
feux	chaleur [n]																													
fi	faire fi de [o]																													
fiacre	carrosse [n]: landau; voiture; cab; citadine; coupe; victoria																													
fiance	personne [n]: futur; pretendu; promis																													
fibre	sentiment [n]: corde	nerf [n]: fibrille; ligament																												
fibreux	filandreux [a]: nerveux																													
fibule	boucle [n]: agrafe; broche																													
ficele	vetu [a]: habille; fagote	attache [a]: lie																												
ficeler	habiller [v]: vetir	attacher [v]: corder; lacer; lier; serrer; brider																												
ficelle	astuce [n]: truc; artifice; subterfuge; carotte	cable [n]: cordage; fil; filiere	procede [n]: maniere; formule; procedure	baguette de pain [n]	galon [n]																									
ficher	introduire [v]: enfoncer; faire penetrer; clouer; fixer; planter; visser	immobiliser sur [v]: arreter sur	faire [v]: travailler	appliquer [v]: flanquer	ficher a la porte [o]: ficher dehors; ficher le camp; ficher par terre; se ficher																									
fichu	condamne [a]: perdu; fini; use	mauvais [a]: maudit; detestable; inconvenant; sacre; foutu	chale [n]: echarpe; foulard; pointe; carre; mantille	fichu de [o]: mal fichu																										
fictif	faux [a]: feint; factice; deguise	invente [a]: allegorique; fabuleux; imaginaire; utopique	conventionnel [a]: suppose; extrinseque																											
fiction	interpretation [n]: invention; imagination; fable; mythe; utopie; conte; allegorie; allusion; chimere	economie [n]: convention	fait [n]: mensonge; dissimulation																											
fidele	conforme [a]: exact; veridique; vrai; correct	devoue [a]: loyal; honnete; sur; probe; constant; perseverant; sincere; scrupuleux; attache; attentif; bon; solide	adepte [n]: croyant; proselyte; ouaille; paroissien; pratiquant	etre fidele a [o]																										
fidelement	docilement [o]: exactement; scrupuleusement																													
fidelite	qualite [n]: devouement; loyalisme; attachement; constance	fait [n]: honnetete; exactitude; objectivite; sincerite; verite; correction	technique [n]: fiabilite																											
fieffe	fini [a]: acheve; complet; parfait; consomme																													
fiel	haine [n]: animosite; antipathie; acrimonie; aigreur; mechancete; humeur; venin	bile [n]	chagrin [n]: douleur; peine; amertume; rancœur																											
fielleux	desagreable [a]: haineux; mechant; envenime; viperin																													
fier	trait de caractere [a]: orgueilleux; dedaigneux; hautain; pretentieux; arrogant; meprisant; altier; haut; distant; suffisant	fier de [a]: content; heureux; satisfait	qualite [a]: noble; digne																											
fier-a-bras	bravache [n]: fanfaron; fendant; matamore																													
fier de	content [o]: satisfait; heureux																													
fiere allure	panache [n]																													
fierement	courageusement [o]: bravement; dignement; le front haut; cranement																													
fierte	orgueil [n]: presomption; dedain; hauteur; arrogance; vanite; morgue; condescendance	hardiesse [n]: intrepidite; vigueur	dignite [n]	contentement [n]: satisfaction																										
fievre	agitation [n]: excitation; emotion; animation; febrilite; fougue; passion; chaleur; folie	temperature [n]: pyrexie; febricule; suette; malaria; paludisme																												
fievreux	brulant [a]: chaud; febrile; maladif	febrile [a]: inquiet; agite; ardent; passionne; tourmente; trouble																												
fifre	pipeau [n]: flute																													
fige	contraint [a]: sclerose; immobilise; paralyse	solidifie [a]: coagule; congele; glace; petrifie; epaissi; caille																												
figer	petrifier [v]: paralyser; immobiliser	coaguler [v]: condenser; cristalliser; durcir; congeler; epaissir; solidifier; cailler	se figer [o]																											
fignoler	orner [v]	soigner [v]: finir; parfaire; parachever																												
figurant	acteur [n]: doublure; second role; comparse																													
figuratif	non figuratif [o]																													
figuration	copie [n]: fac-simile; dessin; plan; schema; carte	representation [n]: symbole; image																												
figure	apparence [n]: air; aspect; maintien; maniere; mine; façon; forme; configuration; conformation; contenance; expression	visage [n]: physionomie; face; tete; traits; facies; frimousse; bouille; binette; bille; bobine; gueule	portrait [n]: image; illustration; effigie; esquisse; representation; silhouette; symbole; schema; metaphore; allusion	personnage [n]: personnalite; type; idole; caractere; nom	faire figure de [o]																									
figure	langue [a]: image																													
figurer	paraitre [v]: jouer un role; representer; compter; tenir un rang	representer [v]: dessiner; peindre; former; sculpter; donner l aspect; avoir la forme	se figurer [o]																											
fil	lame [n]: tranchant	suite [n]: cours; enchainement	telephone [n]: bigophone	former des fils [o]																										
filandreux	complique [a]: ampoule; entortille; fumeux; verbeux	fibreux [a]: coriace																												
file	position [n]: colonne; rangee; procession; rang; defile; queue																													
filer	derouler [v]: devider	tisser [v]: tordre	tenir [v]: developper	decouvrir progressivement [v]	former des fils [v]: monter en fumant	couler [v]: se derouler; glisser	aller tres vite [v]: courir; foncer; passer en courant	epier [v]: suivre	fuir [v]: partir; s en aller; decamper; deguerpir; s esquiver; s echapper; se retirer; disparaitre	donner [v]: refiler																				
filet	ecoulement fin [n]	listel [n]	chateaubriant [n]: tournedos	resille [n]	epuisette [n]: nasse; senne; sardinier; langoustier; thonaire; ableret; araignee; balance; bastude; bolier; bouterolle; carrelet; chalut; drague	lacet [n]: panneau; rets; pan de rets; pan; araignee; allier; lacs; pantiere; ridee; tirasse	porte-bagages [n]: reseau	embuche [n]: souriciere; piege																						
filiation	consanguinite [n]: cognation	genealogie [n]: descendance; famille; lignee; generation	enchainement [n]: liaison																											
filiere	hierarchie [n]: canal; suite de formalites	etireuse [n]	ordre de livraison [n]																											
filin	cordage [n]: cable																													
fille	fillette [n]: demoiselle; adolescente; jouvencelle; catherinette; poulette; tendron; poule; nana; poupee; pepee; souris; frangine; gonzesse	descendante [n]: enfant; heritiere	vieille fille [o]																											
fillette	adolescente [n]: demi-bouteille	petite fille [n]																												
filmer	cinematographier [v]: tourner																													
filon	veine [n]: strate; dyke; couche; masse; source	mine [n]: chance	combine [n]: place; aubaine; planque																											
filou	escroc [n]: tricheur; voleur; fripon; pickpocket; estampeur																													
filouter	tricher au jeu [v]	voler [v]: escroquer; frauder																												
filouterie	chantage [n]: escroquerie; tricherie; larcin; carotte																													
fils	personne [n]: garçon; [informal] fiston; petit; enfant; sang; heritier; [informal] gars; rejeton; progeniture																													
fils de ses œuvres	fruit [n]: effet; resultat; consequence	autodidacte [n]: self-made-man																												
fils spirituel	disciple [n]																													
filtre	purificateur [n]: bougie; epurateur	percolateur [n]: passoire	verification [n]																											
filtre	tamise [a]: epure; purifie; assaini; clarifie; limpide; naturel; propre; salubre; ethere																													
filtrer	mouvement [v]: couler; passer; secreter; suinter; transsuder	qualite [v]: epurer; clarifier; purifier																												
fin	ruse [a]: astucieux; adroit; avise; delie; malin; penetrant; perspicace; clairvoyant; sagace; spirituel; subtil	svelte [a]: tenu; delie; grele; leger; menu; mince	delicat [a]: sensible; suave; affable	superieur [a]: pur; precieux; elegant; joli; soyeux	but [n]: destination; objet; motif; finalite	bout [n]: conclusion; denouement; solution; terme; terminaison; epilogue; couronnement; issue; limite; cloture; confins; extremite	chute [n]: ruine; tombee	mort [n]: trepas; agonie; deces; disparition	a la fin [o]: devenir fin; mettre fin; mettre fin a; prendre fin; sans fin																					
final	dernier [a]: extreme; ultime																													
finalement	definitivement [o]: sans retour	enfin [o]: a la fin; en definitive; en fin de compte																												
finance	finances [o]																													
financer	commanditer [v]	payer [v]																												
finances	banque [n]: bourse; affaires; capital; capitalisme; commerce; credit	argent [n]: ressources; biens; budget; fonds; recettes; depenses; tresor; tresorerie; comptabilite																												
financier	pecuniaire [a]: materiel	banquier [n]: boursier; agent de change; capitaliste; coulissier; gerant; gestionnaire; regisseur																												
finasseur	finassier [o]																													
finassier	finasseur [n]: finaud																													
finaud	malin [a]: matois; madre; malicieux; roue; ruse; fin; fute; habile; retors; roublard; finassier																													
fine gueule	gourmet [n]: gastronome; gourmand																													
finement	adroitement [o]: astucieusement; habilement																													
finesse	sensibilite [n]: acuite; sagacite; clairvoyance; subtilite; perspicacite; penetration; tact	minceur [n]: delicatesse; etroitesse; tenuite; petitesse	delicatesse [n]: elegance; distinction; grace; beaute	artifice [n]: stratageme; ruse																										
fini	acheve [a]: accompli; termine; consomme; revolu	delimite [a]: defini; borne	use [a]: suranne	disparu [a]: evanoui; perdu	parfait [a]: soigne; etudie; poli	fatigue [a]: epuise	mort [a]: fichu; foutu	mechant [a]: sacre; fichu; fieffe																						
finir	polir [v]: parachever; fignoler; lecher; parfaire	achever [v]: accomplir; conclure; terminer; conduire a terme; resoudre; solutionner	cesser [v]: arreter; clore; discontinuer; ne pas continuer; lever; mettre fin a; mettre un terme a	decider [v]: regler; vider	se terminer [v]: tarir; cesser; prendre fin; s achever; s arreter; aboutir	perir [v]: mourir; passer	finir a [o]																							
fiole	figure [n]: tete; bouille	petite bouteille [n]: flacon; ampoule; topette																												
fioriture	ornement [n]																													
firmament	ciel [n]: ether; azur; empyree																													
firme	maison [n]: etablissement; societe; compagnie																													
fisc	finances [n]: Tresor public; finances publiques; impots; assiette fiscale; contributions directes; percepteur; fiscalite																													
fissure	fente [n]: felure; cassure; scissure; rayure; sillon; crevasse; lesion; lezarde; pore																													
fixation	reglementation [n]: limitation; determination																													
fixe	etat [a]: determine; defini; irrefragable; irrevocable; regle; precis; droit	position [a]: immobile; fixe; immuable; invariable; stable; solide; stationnaire; visse; ancre; ineffaçable	duree [a]: continuel; periodique; permanent; regulier; assure; constant																											
fixe	devisage [a]	accroche [a]: affermi; assujetti; maintenu; visse; plante; rive; cloue; attache; immobilise; ancre; enracine	determine [a]: precise; defini; formule; regle	fixe d avance [o]																										
fixer	determiner [v]: preciser; arreter; delimiter; designer; assigner; specifier; imposer; prescrire; reglementer; regler; formuler; indiquer	attacher [v]: consolider; accrocher; affermir; ancrer; assujettir; assurer; immobiliser; implanter; river; sertir; visser; caler	attirer [v]: captiver; conquerir; gagner; retenir	cristalliser [v]: peindre; sculpter; graver	regarder [v]: reperer	renseigner [v]: mettre au fait de; ecrire	se fixer [o]																							
flache	flaque [n]: creux; mare	depression [n]																												
flacon	bouteille [n]: fiole																													
flageller	maltraiter [v]: fouetter; fustiger; battre; chatier; fesser; fouailler	satiriser [v]: attaquer violemment; cingler de critiques																												
flageolant	chancelant [a]: mou																													
flageolet	flute a bec [n]	haricot [n]: fayot																												
flagorner	flatter [v]: cajoler; passer de la pommade; lecher les bottes; lecher les fesses; lecher le cul																													
flagorneur	adulateur [n]: flatteur; louangeur; courtisan; leche-fesses; leche-cul	flatteur [a]: louangeur																												
flagrant	certain [a]: constant; evident; incontestable; patent; criant																													
flair	instinct [n]: clairvoyance; odorat; perspicacite; intuition																													
flairer	pressentir [v]: deviner; prevoir; soupçonner; se douter de	sentir [v]: humer																												
flambant	brillant [a]: etincelant; flamboyant; reluisant; rutilant; scintillant; eclatant	brulant [a]: ardent																												
flambard	gai luron [n]	flambart [n]: charbon a demi consume	faire le flambard [o]																											
flambart	flambard [o]																													
flambe	iris [n]	epee [n]	feu clair [n]: flambee																											
flambe	perdu [a]: ruine; fichu; foutu	passe a la flamme [a]																												
flambeau	objet [n]: fanal; chandelier; candelabre; torche; torchere	savoir [n]: lumiere																												
flambee	augmentation [n]: elevation	feu [n]	explosion d un sentiment [n]																											
flamber	etinceler [v]: flamboyer; scintiller; briller	bruler [v]	faire flamber [o]																											
flamberge	epee [n]: rapiere																													
flamboyant	ardent [a]: eclatant; etincelant; flambant; scintillant; brillant; resplendissant; rutilant																													
flamboyer	briller [v]: petiller	flamber [v]: rougeoyer; bruler																												
flamme	lueur [n]: lumiere; eclat; clarte	feu [n]	passion [n]: zele; amour; animation; ardeur; ferveur	drapeau [n]: banderole; banniere																										
flammeche	parcelle enflammee [n]																													
flanc	sein [n]: entrailles	cote [n]: aile; hanche																												
flancher	ceder [v]: faiblir; mollir; abandonner; reculer; craquer																													
flandrin	grand [n]: mince; dadais																													
flaner	mouvement [v]: se promener; se balader; baguenauder; errer; battre le pave; muser; musarder; lecher les vitrines	maniere, duree [v]: trainer; lanterner; lambiner; [informal] flemmarder; [informal] trainasser																												
flaneur	badaud [a]	oisif [a]: desœuvre; lambin; musard	badaud [n]: promeneur	oisif [n]: desœuvre; trainard; lambin; musard																										
flanquer	accompagner [v]	garnir sur les flancs [v]	entourer [v]: appuyer; defendre; proteger	lancer [v]: jeter; donner; administrer; appliquer; envoyer	flanquer a la porte [o]: flanquer une volee																									
flapi	epuise [a]: ereinte; fatigue; esquinte																													
flaque	mare [n]: flache																													
flasque	faible [a]: inerte; amorphe; anemique; sans vigueur	mou [a]: mollasse; avachi	petit flacon [n]																											
flatter	charmer [v]: delecter; chatouiller; exciter; plaire a; faire plaisir	caresser [v]: cajoler; caliner	embellir [v]: enjoliver; idealiser	favoriser [v]: encourager	leurrer [v]: bercer	aduler [v]: flagorner; honorer; vanter; louanger; louer; complimenter; courtiser; encenser; faire des courbettes	se flatter [o]																							
flatterie	compliment [n]: adulation; courbette; flagornerie; louange; coups d encensoir																													
flatteur	obsequieux [a]: caressant; insinuant; laudatif; mielleux; papelard; patelin; peloteur; calin; emmielle; plat	agreable [a]: delectable; doux; elogieux; seduisant; suave; obligeant; avantageux	flagorneur [n]: louangeur; adulateur; thuriferaire; enjoleur; hypocrite; caudataire; courtisan; faiseur de courbettes; valet; encenseur																											
flatulence	meteorisme [n]: enflure; ballonnement; vent																													
flatuosite	vent [n]: borborygme; gargouillement																													
fleau	desastre [n]: cataclysme; catastrophe; sinistre; ruine; calamite; cholera; plaie																													
fleche	comme une fleche [o]	projectile [n]: trait; carreau; dard; flechette																												
flechi	baisse [a]: diminue	courbe [a]: plie; ploye	calme [a]: attendri; adouci; desarme; emu; touche																											
flechir	ebranler [v]: adoucir; desarmer; attendrir; gagner a sa cause; toucher	plier [v]: ployer; arquer; courber	faiblir [v]: ceder																											
flechissement	flexion [n]: inflexion; courbure																													
flegmatique	calme [a]: impassible; lymphatique; placide; lent; imperturbable; froid; pose																													
flegmatiquement	avec flegme [o]: imperturbablement; impassiblement																													
flegme	calme [n]: decontraction; impassibilite; froideur; placidite; indifference; mollesse; sang-froid; maitrise; apathie; detachement																													
flemard	flemmard [o]																													
flemmard	paresseux [a]: mou; cossard																													
fletri	use [a]: bleme; tape; vieilli; depenaille; ratatine																													
fletrir	faner [v]: ternir; decolorer; defraichir; rider; secher; alterer	avilir [v]: ternir; enlaidir; corrompre; souiller; tarer	stigmatiser [v]: condamner; blamer; deprecier; deshonorer; honnir; vouer a l opprobre	se fletrir [o]																										
fletrissure	discredit [n]: imprecation; deshonneur; infamie; souillure; opprobre; stigmate	dessechement [n]: defloraison																												
fleur	societe [n]: elite; creme; [informal] gratin																													
fleurant	odorant [a]: sentant																													
fleurer	embaumer [v]: parfumer; exhaler; sentir bon																													
fleurette	conter fleurette [o]																													
fleuri	brillant [a]: vif; colore; frais																													
fleurir	briller [v]: prosperer; se developper; etre florissant; progresser; faire flores	s epanouir [v]: eclore	orner [v]: parer; embellir																											
fleuve	nature [n]: riviere; flot; courant; cours; onde																													
flexibilite	docilite [n]	elasticite [n]: souplesse																												
flexible	docile [a]: malleable; souple; maniable; pliant	plastique [a]: pliable; souple; elastique; malleable; maniable; mou; tendre	rendre flexible [o]																											
flexion	courbure [n]: flechissement; inflexion																													
flexueux	sinueux [a]: onduleux; serpentin																													
flibustier	bandit [n]: homme malhonnete	pirate [n]: corsaire; ecumeur; boucanier																												
flic	policier [n]: agent de police; agent de la surete; gardien de la paix; sergent de ville; commissaire de police; poulet; cogne; conde; roussin; argousin																													
flingot	flingue [n]: fusil																													
flingue	flingot [o]																													
flinguer	se flinguer [o]	tirer sur quelqu un [v]																												
flirt	amoureux [n]	amourette [n]: amant; beguin; amour; caprice																												
floculation	agglutination [n]: precipitation; coagulation; ecume																													
flonflons	refrain [n]	accords bruyants [n]																												
flopee	grande quantite [n]: ribambelle; cargaison																													
flores	faire flores [o]																													
florissant	resplendissant [a]: tres bon	riche [a]: prospere; fortune; en pleine expansion; heureux; lance; parvenu	etre florissant [o]																											
flot	maree [n]: flux; courant																													
flots	abondance [n]: affluence; multitude; deluge; foule; debordement; profusion; mer; torrents	vagues [n]: onde; houle; lame																												
flottant	incertain [a]: irresolu; indecis; confus; vague	mobile [a]: changeant; oscillant; vacillant; variable; versatile; voltigeant; papillotant	libre [a]: epars; echevele																											
flotte	flotteur [n]: bouchon	escadre [n]: marine	eau [n]: pluie																											
flottement	hesitation [n]: incertitude; indecision	fluctuation [n]: agitation; balancement																												
flotter	claquer au vent [v]	naviguer [v]: surnager; ondoyer; onduler; emerger; etre porte; nager; se soutenir; voguer	hesiter [v]: etre incertain	errer [v]: voltiger; aller au hasard; n etre pas retenu; s agiter; tatonner	pleuvoir [v]																									
flou	incertain [a]: vague; indecis; nebuleux	brumeux [a]: vaporeux; fondu; indistinct; efface; leger																												
flouze	finances [n]: argent; [informal] fric; [informal] peze; [informal] pognon; [informal] oseille																													
fluctuant	incertain [a]: inconstant; instable; flottant																													
fluctuation	flottement [n]: changement; hesitation; incertitude; indecision; irresolution; variation	oscillation [n]: balancement; instabilite; va-et-vient																												
fluer	couler [v]: s ecouler; s epancher																													
fluet	mince [a]: faible; chetif; delicat; elance; grele; petit; frele; maigre; menu; gracile; efflanque; debile																													
fluide	inconsistant [a]: fluctuant; indecis; insaisissable	coulant [a]: limpide; liquide; clair	liquide [n]	emanation [n]: flux; onde; radiation	peu fluide [o]																									
fluidite	facilite [n]: regularite																													
flute	fifre [n]: flageolet; chalumeau; piccolo; pipeau	zut [o]	jouer des flutes [o]: se tirer des flutes																											
fluteau	petite flute [n]: flageolet; flutiau; chalumeau																													
flutiau	fluteau [o]																													
flux	ecoulement [n]	maree montante [n]: flot; vague	abondance [n]: afflux; profusion; debordement																											
fœtus	embryon [n]: œuf; germe																													
foi	confiance [n]: creance; opinion; persuasion; autorite; conviction; temoignage	fidelite [n]: exactitude; sincerite; droiture; franchise; honnetete; veracite	religion [n]: croyance; confession; dogme	promesse [n]: serment; engagement	ajouter foi [o]: avoir foi en; avoir la foi; bonne foi; de bonne foi; ma foi; mauvaise foi; profession de foi																									
foin	tumulte [n]: scandale; petard	fenaison [n]: fourrage																												
foirail	champ de foire [n]																													
foire	economie [n]: exposition; salon; exhibition	commerce [n]: marche	societe [n]: fete foraine; kermesse; festivite; evenement	faire la foire [n]: bringue; bombe; nouba; fete																										
foirer	rater [v]: echouer lamentablement	tourner sans mordre [v]	avoir la diarrhee [v]																											
foireux	diarrheique [a]	lache [a]: peureux																												
fois	frequence [o]: chaque fois que; des fois; parfois; quelquefois																													
foison	a foison [o]	profusion [n]: abondance																												
foisonnement	abondance [n]: pullulement																													
foisonner	abonder [v]: pulluler; regorger																													
folatre	gai [a]: badin; enjoue; jovial; joyeux; plaisant; vagabond; espiegle; folichon; guilleret																													
folatrer	batifoler [v]: badiner; s ebattre																													
folichon	gai [a]: folatre; amusant; badin																													
folie	aberration [n]: deraison; divagation; egarement; insanite; aveuglement; inconscience; absurdite; delire; vesanie; monomanie	demence [n]: alienation mentale; delire; psychose; nevrose; desequilibre mental; hallucination	extravagance [n]: bizarrerie; frasque; fredaine; caprice; fantaisie; betise; manie; sottise; passion; marotte; toquade	a la folie [o]																										
follement	tres [o]: a la folie; extremement; eperdument																													
fomentateur	excitateur [a]: fauteur																													
fomenter	causer [v]: envenimer; exciter; allumer																													
fonce	sombre [a]: obscur																													
foncer	changer de couleur [v]	creuser [v]: forer	attaquer [v]: charger; se jeter sur; fondre sur	filer [v]: aller tres vite; rouler a toute allure																										
foncier	cadastre [n]: immeubles; impot sur les immeubles	inne [a]: profond																												
foncierement	profondement [o]: fondamentalement																													
fonction	position [n]: place; situation; poste; role; hierarchie	emploi [n]: metier; occupation; profession; office; mission; ministere; service; affaire; charge; dignite	etre fonction de [o]: faire fonction de; haute fonction																											
fonctionnaire	budgetivore [n]: bureaucrate; rond-de-cuir; gratte-papier	employe [n]: administrateur; agent																												
fonctionnement	fait [n]: marche; activite; action; jeu; travail; manœuvre																													
fonctionner	actionner [v]: manœuvrer	agir [v]	travailler [v]	marcher [v]: se mouvoir; aller; avancer; tourner	faire fonctionner [o]: faire fonctionner prudemment																									
fond	substratum [n]: substance; base; contenu; sujet; theme; source; matiere; tissure; toile	bas [n]: base; bas-fond; creux; cuvette; fondement; abysse	essence [n]: nature; nœud; caractere; interieur; arriere-fond; realite profonde; secret	champ [n]: perspective; plan	a fond [o]: a fond de train; au fond																									
fondamental	principal [a]: primordial; capital; elementaire; foncier; initial; essentiel; premier; radical																													
fondamentalement	foncierement [o]: radicalement; totalement; essentiellement																													
fondant	mouille [a]: ruisselant	juteux [a]: aqueux																												
fondateur	createur [n]: batisseur; pere; chef																													
fondation	donation [n]: legs	creation [n]: formation; instauration; institution; constitution; etablissement	base [n]: fondement; assise; assiette; armature																											
fonde	mal fonde [o]	vrai [a]: veridique; avere; juste; reel; serieux; solide; legitime; licite; rationnel																												
fondement	base [n]: soutien; assise; appui	motif [n]: cause; raison; principe; provenance; fond; germe; consistance; pretexte; preuve	sans fondement [o]																											
fonder	construction [v]: etablir; batir; creer; echafauder; edifier; eriger; constituer; instituer; organiser; ouvrir	langue [v]: justifier; motiver; appuyer																												
fondeur	metallo [n]: metallurgiste																													
fondre	combiner [v]: confondre; amalgamer; fusionner; incorporer; meler; reunir; unir; harmoniser	liquefier [v]: dissoudre; delayer; diluer	diminuer [v]: disparaitre; se dissiper	se degeler [v]: se dissoudre; se liquefier	maigrir [v]	faire fondre [o]: fondre sur; se fondre																								
fondre sur	s abattre sur [v]: se jeter sur; se ruer sur; se precipiter sur; s elancer sur; tomber sur; assaillir; charger; attaquer																													
fortin	forteresse [n]: fort; blockhaus																													
fortuit	accidentel [a]: contingent; inattendu; inopine; occasionnel; imprevu																													
fortuitement	accidentellement [o]: occasionnellement; par hasard; par accident; sans cause																													
fortune	finances [n]: richesse; argent; biens; avoir; capital; patrimoine; ressources; moyens; aisance; opulence; tresor	etat [n]: succes; prosperite; bonheur; felicite; aubaine	fait [n]: hasard; chance; sort; destin; etoile																											
fortune	prospere [a]: riche; florissant	heureux [a]: chanceux																												
fosse	creux [n]: excavation; cavite; trou; fosse; gouffre; fouille; tombe																													
fosse	cassure [n]: coupure; abime; gouffre	tranchee [n]: canal; rigole; ruisseau; saut-de-loup; excavation																												
fossile	vieille baderne [n]: vieille barbe	suranne [a]: demode; depasse; vieux																												
fossilise	fige [a]: arriere; petrifie	petrifie [a]																												
fou	insense [a]: egare; ecervele; inconscient; bete; braque; timbre; toque; fele; maboul; cingle; cinoque	malade mental [a]: dement; aliene; nevrose; desequilibre	extravagant [a]: insense; absurde; anormal; deraisonnable; irrationnel; loufoque; dingue	ardent [a]: enjoue; petulant; vif; gai; folatre	amoureux [a]: engoue; epris; entiche	grand [a]: enorme; beaucoup; terrible; excessif	dement [n]: malade; nevrose; psychotique; aliene; desequilibre	inconscient [n]: insense; idiot; maniaque; obsede; energumene; eperdu; fada; dingue; detraque; braque; cingle	etre fou de [o]																					
fouace	fougasse [o]																													
fouailler	fouetter [v]: battre; flageller; fustiger; cingler; cravacher																													
foucade	elan capricieux [n]: caprice; emportement passager; fantaisie; toquade																													
foudre	colere [n]: vengeance; courroux	eclair [n]: tonnerre; feu du ciel	tonneau [n]: futaille	coup de foudre [o]: foudres																										
foudres	condamnation [n]: excommunication																													
foudroyant	brusque [a]: immediat; instantane; soudain; brutal; mortel	fulgurant [a]																												
foudroyer	terrasser [v]: renverser; tuer; aneantir	frapper de la foudre [v]	stupefier [v]: confondre; interdire; atterrer																											
fouet	objet [n]: cravache; martinet; chat a neuf queues; chambriere; discipline; knout	cuisine [n]: batteur																												
fouetter	agiter [v]: battre; meler	fouailler [v]: flageller; cingler; fustiger	stimuler [v]: allumer; exciter; animer; irriter; emoustiller																											
fougasse	fouace [n]: galette																													
fougue	emportement [n]: emballement; ardeur; impetuosite; vehemence; elan; virulence; violence; entrain; passion; feu; fievre; mordant; precipitation																													
fougueux	emporte [a]: ardent; bouillant; enflamme; enthousiaste; impetueux; vehement; violent; petulant; explosif; vif; chaud; chaleureux; fanatique; indompte																													
fouille	inspection [n]: examen; perquisition	fosse [n]: ouverture; mine; puits	visite [n]: recherche; reconnaissance																											
fouiller	battre [v]: explorer	retourner [v]: creuser; fouir; miner	fouger [v]: fouir	visiter [v]	inspecter [v]: examiner; perquisitionner	approfondir [v]: rechercher; travailler; etudier	fureter [v]: fourrager; fourgonner; trifouiller; farfouiller; fouiner	se fouiller [o]																						
fouilleur	fouineur [n]: rat de bibliotheque; fureteur																													
fouillis	desordre [n]: confusion; fatras; meli-melo; capharnaüm																													
fouinard	fouineur [n]: fureteur	fouineur [a]: fureteur																												
fouiner	fouiller [v]: fureter																													
fouineur	curieux [n]: fureteur; fouinard	curieux [a]: fureteur; fouinard																												
fouir	creuser [v]																													
foulard	echarpe [n]: fichu; cache-col																													
foule	personne [n]: affluence; monde; bousculade; presse; cohue; cortege; troupe	quantite [n]: masse; multitude; armee; collection; regiment; troupeau; populo; flopee																												
fouler	bafouer [v]: mepriser; pietiner; accabler	pietiner [v]: marcher sur; ecraser; piler; tasser; damer	demettre [v]: luxer; disloquer	se fouler [o]: se fouler la rate																										
four	echec [n]: insucces; desastre; chute	chaufour [n]: fournil																												
fourbe	perfide [a]: malhonnete; indelicat; hypocrite; faux; fallacieux; sournois; trompeur; menteur; traitre																													
fourberie	fourberie habile [o]	ruse [n]: hypocrisie; faussete; duplicite; sournoiserie; trahison; fraude; piperie; matoiserie																												
fourbi	choses en desordre [n]	attirail [n]: chargement; bagage; barda	machin [n]: chose; truc; bidule																											
fourbir	frotter [v]: derouiller; astiquer; nettoyer; polir																													
fourbu	extenue [a]: fatigue; epuise; ereinte; brise; echine; harasse; moulu; rendu; rompu; esquinte																													
fourche	fourches patibulaires [o]	bifurcation [n]: embranchement; carrefour																												
fourcher	bifurquer [v]: se diviser																													
fourchu	crochu [a]: cornu																													
fourgon	wagon [n]	pique-feu [n]: tisonnier																												
fourierisme	socialisme [n]: associationnisme																													
fourmillant	populeux [a]: grouillant																													
fourmiller	grouiller [v]: pulluler; abonder																													
fournaise	four [n]: fourneau	canicule [n]																												
fourneau	four [n]	cuisiniere [n]: rechaud																												
fourni	abondant [a]: touffu; epais; feuillu; dru																													
fournir	procurer [v]: ravitailler; alimenter; approvisionner; donner; livrer; preter	munir [v]: garnir; armer; pourvoir	accomplir [v]: achever; parfaire	subvenir [v]: contribuer	faire fournir [o]: se fournir																									
fournisseur	pourvoyeur [n]: ravitailleur; approvisionneur; commerçant; detaillant; marchand																													
fourniture	garniture [n]: assaisonnement	approvisionnement [n]: livraison; marchandise; stock	prestation [n]																											
fourrager	fouiller [v]: fureter; fourgonner	ravager [v]: piller; marauder; devaster; ruiner; saccager; desoler																												
fourre	buisson [n]: taillis																													
fourreau	cosse [n]	etui [n]: gaine; enveloppe	fonte [n]																											
fourrer	introduire [v]: inserer; enfoncer; enfourner; mettre dans; flanquer; foutre	envelopper [v]: garnir; doubler	se fourrer [o]																											
fourrure	animal [n]: poil; pelisse; pelage; toison; pelleterie																													
fourvoiement	erreur [n]: bevue; aberration; egarement; contresens; meprise; sottise																													
fourvoyer	se fourvoyer [o]	egarer [v]: tromper; detourner; induire en erreur																												
foutoir	grand desordre [n]: bordel																													
foutre	mettre [v]: deposer; enfoncer; flanquer	sperme [n]	faire [v]: ficher	foutre a la porte [o]: foutre dehors; foutre le camp; s en foutre; se foutre																										
foutre a la porte	congedier [v]: licencier; chasser; foutre dehors																													
foutre dehors	congedier [v]: licencier; chasser																													
foutre le camp	fuir [v]: partir																													
foutu	sacre [a]: sale; fichu	perdu [a]: condamne; fini; maudit; use	bati [a]: fait; fichu																											
foyer	maison [n]: demeure; domicile; appartement; menage; famille; penates; bercail	cheminee [n]: feu; atre; fourneau; brasier	centre [n]: siege; source; milieu; interieur																											
fracas	tumulte [n]: vacarme; tapage; bruit; clameur																													
fracasser	briser [v]: casser; rompre; mettre en pieces																													
fraction	partie [n]: morceau; portion; section; part; segment; tranche; division; detail; parcelle																													
fractionnement	segmentation [n]: division; morcellement; eparpillement																													
fractionner	segmenter [v]: partager; sectionner; diviser; morceler; subdiviser																													
fracture	rupture [n]: cassure; blessure; faille; coupure																													
fragile	cassant [a]: facile a briser	frele [a]: debile; delicat; faible; chetif; malingre	instable [a]: incertain; chancelant; passager; precaire; provisoire; vacillant; changeant; inconstant; ephemere; perissable; momentane; labile																											
fragilite	precarite [n]: incertitude; instabilite; inconsistance	faiblesse [n]: debilite; delicatesse																												
fragment	extrait [n]: citation; partie; passage; piece; division; detail	morceau [n]: segment; echantillon; miette; parcelle; tronçon; bout; bouture; chicot; debris; lambeau; lopin; loque																												
fragmentaire	partiel [a]: incomplet																													
fragmenter	partager [v]: morceler; diviser; concasser																													
fragrance	odeur [n]: parfum																													
frai	fretin [n]: alevin	reproduction [n]: generation; œuf																												
fraichement	recemment [o]: depuis peu; nouvellement	au frais [o]	froidement [o]: avec froideur																											
fraicheur	nature [a]: frais; froid	qualite [n]: nouveaute; primeur	effet [n]: eclat; lustre	trait de caractere [n]: purete; innocence; naivete; spontaneite; jeunesse; naturel; vigueur; vivacite																										
fraichir	se lever [v]: augmenter de force	rafraichir [v]: se rafraichir																												
frais	nature [a]: frisquet; legerement froid	qualite [a]: nouveau; neuf; jeune; recent; du jour; printanier; tendre	effet [a]: eclatant; brillant; joli	etat [a]: intact; propre	etat physique [a]: detendu; dispos; repose; sain; vigoureux; bien conserve; vif; alerte; en forme; vert	finances [n]: cout; charge; debours; depens; depense; taxe																								
fraise	nature [n]: fruit rouge	medecine [n]: lesion de la peau; angiome; nævus	animal [n]: mesentere; caroncule	objet [n]: collerette	technique [n]: foret; roulette	corps [n]: figure																								
franc	trait de caractere [a]: sincere; spontane; honnete; ouvert; droit; loyal; cordial; direct; naturel; simple; sans façon; vrai; veritable	commerce [a]: libre; exempt; exonere	etat [a]: precis; net; declare; carre	finances [n]: unite monetaire																										
franchement	resolument [o]: sans hesiter; sans ambages; carrement; tout net; nettement	sincerement [o]: rondement; loyalement; a cœur ouvert; en toute franchise; librement; ouvertement; simplement																												
franchir	passer [v]: depasser	enjamber [v]: escalader; monter; sauter; sauter par-dessus	traverser [v]: parcourir	outrepasser [v]	surmonter [v]: vaincre																									
franchise	sincerite [n]: loyaute; spontaneite; droiture; rondeur; veracite; verite; franc-parler	exemption [n]: exoneration; dispense; immunite; privilege	liberte [n]: independance	en toute franchise [o]																										
franchissement	passage [n]: escalade; traversee																													
franc-tireur	maquisard [n]: partisan; resistant																													
frange	bord [n]: marge																													
frange	decoupe [a]: dechiquete	orne [a]: borde																												
franquette	a la bonne franquette [o]																													
frappant	impressionnant [a]: saisissant; surprenant; troublant; extraordinaire; sensationnel; etonnant; attachant; captivant; criant; eclatant																													
frappe	voyou [n]: gouape	dactylographie [n]																												
frappe	frais [a]: froid; rafraichi; refroidi	battu [a]	inquiet [a]: emu	fou [a]																										
frapper	punir [v]: chatier	battre [v]: cogner; heurter; donner un coup; brutaliser; rudoyer; maltraiter; cingler; fouetter; rosser	marteler [v]: percuter	foudroyer [v]	tapoter [v]: taper; tambouriner	impressionner [v]: surprendre; etonner; saisir; choquer	affecter [v]: atteindre; toucher; emouvoir; affliger; consterner	frapper a mort [o]: se frapper																						
frasque	fredaine [n]: equipee; caprice; incartade																													
fraternel	uni [a]: amical; cordial; affectueux																													
fraude	tromperie [n]: escroquerie; deloyaute; fourberie; improbite; tricherie; supercherie; contrebande; mauvaise foi																													
frauder	denaturer [v]: frelater; sophistiquer	tromper [v]: tricher; escamoter; abuser; voler; filouter																												
fraudeur	falsificateur [n]: contrebandier																													
frayer	aleviner [v]: se reproduire	preparer [v]: percer; ouvrir; entrouvrir; rendre praticable; tracer; faciliter; pratiquer; etablir	froler [v]: frotter contre	frequenter [v]: cotoyer; coudoyer; hanter; voir; voisiner; frequenter; commercer; etre en relation avec																										
frayeur	saisissement [n]: peur; effroi; frissonnement; apprehension; crainte; epouvante; terreur; alarme; transe																													
fredaine	ecart [n]: debordement; equipee; escapade; folie; frasque; incartade; fugue; caprice																													
fredonner	chanter [v]: chantonner																													
frein	filet [n]	mors [n]	obstacle [n]: limite; opposition	mettre un frein a [o]: ronger son frein																										
freiner	arreter [v]: stopper; bloquer	ralentir [v]: decelerer; retenir; serrer	enrayer [v]: faire obstacle; gener; refrener; moderer; contrarier; diminuer																											
frelatage	contrefaçon [n]: fraude																													
frelater	falsifier [v]: denaturer; contrefaire; fausser; sophistiquer																													
frele	fragile [a]: delicat; chetif; debile; faible; fluet; maigre; peu resistant; peu solide																													
freluquet	godulereau [n]: mirliflore																													
fremir	murmurer [v]: bruire	trembler [v]: frissonner; palpiter; trepider; tressaillir																												
fremissant	ardent [a]: passionne; vibrant; tremblant																													
fremissement	tremblement [n]: tressaillement; vibration; frisson; frissonnement; emotion	murmure [n]: bruissement																												
frenesie	folie [n]: passion; enthousiasme; aveuglement; delire; agitation; egarement	fureur [n]: furie; emportement; rage																												
frenetique	violent [a]: furieux	fou [a]: delirant; enthousiaste; passionne; effrene																												
frequemment	souvent [o]: beaucoup; communement																													
frequent	maniere [a]: habituel; commun; normal; courant; ordinaire	frequence [a]: repete; multiple; nombreux; continuel; continu; perpetuel; reitere; rebattu; quotidien; innombrable; journalier																												
frequentation	amour [n]: amourette	contact [n]: accointance; commerce; intimite; liaison; lien; rapport; relation; amitie	pratique [n]: usage	assiduite [n]: regularite; ponctualite; exactitude																										
frequente	peu frequente [o]	populeux [a]: public; passant																												
frequenter	se frequenter [o]	hanter [v]: frayer avec; pratiquer; cotoyer; courir; visiter; voisiner; commercer; coudoyer; voir																												
frere	personne, famille [n]: [informal] frerot; [informal] frangin	personne [n]: semblable; ami; compagnon; confrere; camarade; copain	religion [n]: religieux; capucin; franciscain; dominicain																											
fret	charge [n]: cargaison	louage [n]: affretement; nolis																												
freter	equiper [v]: charger	louer [v]: affreter; noliser																												
fretillant	remuant [a]: grouillant; semillant; sautillant; trepignant; vif																													
fretiller	remuer [v]: s agiter; sautiller; se tremousser; grouiller; piaffer; tremousser; trepigner; gigoter																													
fretin	rebut [n]: rien; quantite negligeable; dechet	blanchaille [n]: menu poisson; alevin; frai; nourrain																												
freux	corneille [n]																													
friable	cassant [a]	tendre [a]: sablonneux																												
friand	appetissant [a]: exquis; delectable; delicieux; succulent; allechant; tentant; savoureux	gourmand [a]	friand de [o]																											
friand de	avide de [a]: amateur																													
friandise	sucrerie [n]: patisserie; gourmandise; confiserie; delicatesse; douceur; chatterie; bonbon																													
fricassee	melange [n]: amalgame; meli-melo; salmigondis	fricandeau [n]: blanquette; ragout; gibelotte; salmis; fricot	fricassee de museaux [o]																											
fricassee de museaux	embrassade [n]: gros baisers																													
fricasser	gaspiller [v]: dissiper; perdre	accommoder [v]: preparer; faire frire; frire																												
fric-frac	effraction [n]: cambriolage																													
friche	en friche [o]	lande [n]: champ abandonne; champ inculte; champ sauvage; terre non cultivee																												
frichti	repas [n]: fricot																													
fricot	repas [n]: fricassee; frichti																													
fricotage	trafic malhonnete [n]: magouille; tripotage																													
fricoter	manigancer [v]: trafiquer; tramer; tripoter; mijoter	accommoder en ragout [v]: preparer un plat; cuisiner																												
friction	heurt [n]: accrochage	frottement [n]																												
frictionner	frotter [v]: oindre																													
frigidaire	refrigerateur [n]: frigo																													
frigo	chambre frigorifique [n]	refrigerateur [n]: frigidaire	viande frigorifiee [n]																											
frigorifier	intimider [v]	refrigerer [v]: congeler																												
frimas	froid [n]: hiver																													
frime	semblant [n]: comedie; hablerie; apparence trompeuse																													
frimousse	visage [n]: figure																													
fringale	envie [n]	appetit [n]: faim																												
fringant	alerte [a]: petulant; agile; sautillant; guilleret; semillant; ingambe; actif; pimpant	fougueux [a]: vif																												
fringuer	se fringuer [o]	vetir [v]: habiller; nipper																												
friper	chiffonner [v]: fletrir; rider																													
fripon	espiegle [a]: polisson; malicieux; malin; delure; eveille; coquin; volage	brigand [n]: coquin; vaurien; garnement; galopin	escroc [n]: filou; larron; voleur																											
friponne	coquette [a]																													
friponnerie	coquinerie [n]: malhonnetete; canaillerie																													
fripouille	crapule [n]: escroc; canaille																													
frire	cuisine [v]: faire cuire; rotir; faire sauter; fricasser																													
friser	effleurer [v]: froler; raser	boucler [v]: anneler; creper; onduler; moutonner; faire une mise en plis	confiner a [v]: approcher de																											
frisquet	nature [a]: frais; froid																													
frisson	froissement [n]: bruissement	fremissement [n]: tremblement; tressaillement; frissonnement	emotion [n]: effroi; crainte; peur; alarme; saisissement																											
frissonnement	frayeur [n]: fremissement																													
frissonner	apprehender [v]: craindre	trembler [v]: fremir; grelotter; tressaillir																												
frivole	insouciant [a]: leger; inconsequent; peu serieux; pueril; superficiel; etourdi	futile [a]: insignifiant; superficiel; inconsistant; vain; vide																												
frivolite	futilite [n]: bagatelle; fantaisie; caprice; amusette; fanfreluche; babiole; broutille	insouciance [n]: legerete; inconstance; puerilite; vanite																												
froc	pantalon [n]	bure [n]: habit monacal																												
froid	nature [a]: frisquet; frais; glace; glacial; siberien; rude	trait de caractere [a]: insensible; glacial; flegmatique; impassible; indifferent; reserve; severe; sec; austere; detache; distant; frigide; piquant	art [a]: ennuyeux; inexpressif; languissant; terne	etat [n]: hiver; bise; gelee; glace; froidure	etat mental [n]: froideur; desaccord; discorde; brouille; dissentiment; mecontentement; mesentente; antipathie; mesintelligence																									
froidement	avec indifference [o]	fraichement [o]	calmement [o]																											
froideur	etat mental [n]: indifference; impassibilite; flegme; reserve; detachement; severite; hostilite; glace																													
froidure	froid [n]: fraicheur																													
froisse	vexe [a]: pique; blesse; choque; offusque; offense; desoblige; mortifie	chiffonne [a]: fripe																												
froissement	heurt [n]: friction; blessure																													
froisser	meurtrir [v]: claquer	chiffonner [v]: plisser; friper	broyer [v]: ecraser; pietiner	vexer [v]: offenser; piquer; blesser; choquer; desobliger; indisposer; offusquer; blesser; heurter	se froisser [o]																									
frolement	relation [n]: caresse; attouchement	son [n]: froissement; fremissement																												
froler	cotoyer [v]: coudoyer	effleurer [v]: caresser; toucher legerement	raser [v]: serrer	passer pres de [v]: friser; risquer																										
froleur	peloteur [n]: tripoteur																													
froleuse	aguicheuse [n]: allumeuse																													
froment	nature [n]: cereale; ble																													
froncer	plisser [v]: rider; grigner																													
frondaison	feuillage [n]: feuillee; feuilles; branches; branchage; ramure; verdure	ombre [n]: ombrage; abri																												
fronder	critiquer [v]: desapprouver; reprouver; trouver a redire; attaquer; blamer; censurer; condamner; reprendre; satiriser																													
frondeur	moqueur [n]: rebelle; railleur; contestataire; perturbateur	moqueur [a]: satirique; rebelle; railleur; contestataire; perturbateur																												
front	coalition [n]: ligue; bloc; cartel; groupement	face [n]: façade; fronton	champ de bataille [n]: lignes	audace [n]: impudence; hardiesse	air [n]: maintien	faire front [o]: le front haut																								
frontiere	limite [n]: borne; lisiere; confins; ligne; demarcation; delimitation																													
frotter	effet [v]: nettoyer; essuyer; astiquer; briquer; brosser; fourbir; gratter; racler; cirer; encaustiquer; lustrer; polir; poncer; recurer	mouvement [v]: effleurer; froler; frictionner; appuyer; gratter	frotter de [v]: huiler; oindre; graisser																											
frou-frou	froissement [n]: fremissement; bruissement																													
froussard	peureux [a]: poltron; lache																													
frousse	peur [n]: crainte; trac																													
fructifier	rapporter [v]: rendre; produire; developper																													
fructueux	maniere [a]: profitable; productif; lucratif; avantageux; fecond; fertile; salutaire; utile; rentable; abondant; bon																													
frugal	sobre [a]: simple; austere; ascetique																													
frugalite	sobriete [n]: moderation; temperance; simplicite; economie																													
fruit	nature [n]: fruits rouges; fruits a pepins; fruits secs; fruits de mer	effet [n]: benefice; produit; profit; resultat; recompense; avantage; consequence; rapport																												
fruitier	fromagerie [n]	fruiterie [n]: verger	fromager [n]: maitre fruitier																											
frusques	hardes [n]: fringues; nippes																													
fruste	grossier [a]: rude; inculte; lourd; lourdaud; primitif; balourd; sauvage																													
frustrer	tromper [v]: decevoir; desappointer	priver [v]: desavantager; depouiller; deposseder; desheriter; voler; spolier; leser; defavoriser																												
fuel	mazout [n]: fuel-oil; fioul																													
fugace	evanescent [a]: passager; ephemere; momentane; fugitif; bref; court; perissable																													
fugitif	mouvant [a]: mobile; instable; inconstant; incertain	fuyant [a]: fuyard; evade; banni; proscrit; exile	evanescent [a]: fugace; ephemere; passager; court; peu durable; bref; court; momentane; perissable	fuyard [n]: evade; deserteur																										
fugue	fuite [n]: echappee; escapade; absence; fredaine; equipee	canon [n]: imitation																												
fuir	eviter [v]: echapper; differer; se garder; se garantir contre; eluder; se soustraire a	s enfuir [v]: decamper; filer; s echapper; s evader; se sauver; s eloigner; deloger; s exiler; s esquiver; deguerpir; s envoler; detaler; ficher le camp; se barrer	s ecouler [v]: passer; s evanouir	perdre [v]	faire fuir [o]																									
fuite	subterfuge [n]: echappatoire; faux-fuyant; excuse; derobade	fugue [n]: evasion; debacle; debandade; deroute; echappee; sauve-qui-peut	hemorragie [n]: perte	defection [n]: lachage	trou [n]: fente	mettre en fuite [o]																								
fulgurant	violent [a]	foudroyant [a]: etincelant; brillant; eclatant; resplendissant; rutilant																												
fulguration	lueur [n]: eclair																													
fulminant	furibond [a]: grondant; menaçant	foudroyant [a]: vociferant; tonitruant	detonant [a]: explosif																											
fulmination	explosion [n]: detonation	colere [n]: explosion																												
fulminer	exploser [v]: eclater; detoner; tonner; faire explosion; tempeter; menacer; pester; s emporter																													
fumant	ardent [a]: bouillonnant; brulant	crachant la fumee [a]: fumeux	sensationnel [a]: formidable; sensas																											
fumee	etat [n]: vapeur; nuage; smog; buee; fumerolle; gaz; fumet; emanation; exhalaison																													
fumees	laissees [n]: excrements; fiente	ivresse [n]: excitation; etourdissement																												
fumer	boucaner [v]: saurer	griller une cigarette [v]	engraisser [v]: fertiliser																											
fumet	odeur [n]: saveur; senteur; exhalaison; parfum																													
fumeux	trouble [a]: vague; obscur; brumeux; nebuleux; abstrait; complique	fumant [a]																												
fumier	purin [n]: terreau; engrais; compost; amendement	ordure [n]: immondice; gadoue	individu meprisable [n]: salaud; salopard; ordure																											
fumiste	plaisantin [n]: mystificateur; farceur																													
funebre	funeraire [a]: mortuaire	lugubre [a]: macabre; sinistre; sombre; qui evoque la mort; triste																												
funerailles	fait [n]: obseques; enterrement; ensevelissement; sepulture; inhumation; incineration; convoi																													
funeste	triste [a]: douloureux; tragique; lamentable; sombre; funebre; malheureux; sinistre; navrant	pernicieux [a]: nuisible; nefaste; desastreux; malfaisant; catastrophique; mortel; mauvais; fatal																												
fureter	fouiller [v]: explorer; fouiner; farfouiller; fourgonner; perquisitionner; rechercher	chasser au furet [v]																												
fureteur	chercheur [n]: fouilleur	curieux [a]: indiscret; fouineur; fouinard																												
fureur	passion [n]: emportement; folie; frenesie; enthousiasme; exaltation; possession; transport; surexcitation	rage [n]: furie; colere; impetuosite; violence; emportement; acharnement; agitation; courroux	etre en fureur [o]: faire fureur																											
furibard	furieux [a]: furibond																													
furibond	furieux [a]: emporte; agite; forcene; irrite; furibard																													
furie	fureur [n]: agitation; colere; courroux; dechainement; ferocite; rage; violence; emportement; impetuosite; dechainement; passion; manie	megere [n]: harpie	ardeur [n]: courage	en furie [o]																										
furieusement	excessivement [o]: extremement																													
furieux	personne [n]: enrage; fanatique; forcene; energumene	trait de caractere [a]: irrite; furibond; enrage; acharne; hors de soi; agite; dechaine; courrouce; delirant; frenetique; possede; forcene; passionne; violent; furibard																												
furoncle	medecine [n]: abces; anthrax; [informal] clou																													
furtif	rapide [a]: fugace; fugitif	cache [a]: clandestin; discret; secret; subreptice																												
furtivement	secretement [o]: en secret; en cachette; a la derobee; en sous-main																													
fusee	missile [n]: lanceur; propulseur; pousseur; accelerateur; booster																													
fuser	jaillir [v]: partir	couler [v]: se repandre en fondant	glisser [v]: se repandre peu a peu																											
fusil	arquebuse [n]: escopette; espingole; tromblon	carabine [n]: mousquet; mousqueton; canardiere; rifle	petoire [n]: flingue; flingot																											
fusiller	passer par les armes [v]: executer; tuer																													
fusion	reunion [n]: combinaison; conciliation; melange	fonte [n]: liquefaction	faire fusion [o]																											
fusionner	s unir [v]: faire fusion; se fondre	assembler [v]: joindre; meler; unifier																												
fustigation	chatiment [n]: peine	stigmatisation [n]: blame	massage [n]																											
fustiger	blamer [v]: stigmatiser; critiquer; reprimander	battre [v]: flageller; fouetter; fouailler; cingler																												
fut	objet [n]: tonneau; baril; futaille; tonnelet	nature [n]: tronc d arbre																												
futaie	boqueteau [n]: bosquet; bouquet d arbres; massif d arbres; frondaison; fourre; taillis; sous-bois; chenaie; hetraie; pinede; sapiniere; sylve; bois																													
futaille	baril [n]: barrique; tonneau; foudre; fut; piece																													
fute	ruse [a]: adroit; habile; malicieux; malin; matois; finaud; madre; roue																													
futile	frivole [a]: insignifiant; pueril; superficiel; inutile; inepte; vain; vide; creux; banal; leger																													
futilite	frivolite [n]: bagatelle; niaiserie; insignifiance; legerete; nullite; enfantillage; puerilite; inanite; broutille																													
futur	temps [n]: avenir; lendemain; perspective; destin	temps [a]: ulterieur; prochain; posterieur; en herbe	personne [n]: fiance																											
fuyant	insaisissable [a]	fugitif [a]: evasif																												
fuyard	deserteur [n]: evade; fugitif	lache [a]: porte a s enfuir																												
faire la causette	causette [v]: bavarder; discuter																													
